[Demensions]
7x7

[TileDemensions]
64x64

[Textures]
Inside\Furni\Desk 64 64
Inside\Floors\Tile_Grey 64 64
Inside\Floors\Wood 64 64
Inside\Furni\boat 128 64

[TileLayer]
02|02|02|02|02|02|02
02|02|02|02|02|02|02
02|02|02|02|02|02|02
02|02|02|02|02|02|02
02|02|02|02|02|02|02
02|02|02|02|02|02|02
02|02|02|01|02|02|02

[TileLayer]
-1|-1|-1|-1|-1|-1|-1
-1|03|-1|-1|03|-1|-1
-1|-1|-1|-1|-1|-1|-1
-1|-1|-1|-1|-1|-1|-1
-1|-1|-1|-1|-1|-1|-1
-1|-1|-1|-1|-1|00|-1
-1|-1|-1|-1|-1|-1|-1

[CollisionLayer]
-1|-1|-1|-1|-1|-1|-1
-1|-2|-2|-1|-2|-2|-1
-1|-1|-1|-1|-1|-1|-1
-1|-1|-1|-1|-1|-1|-1
-1|-1|-1|-1|-1|-1|-1
-1|-1|-1|-1|-1|-2|-1
-1|-1|-1|-1|-1|-1|-1

