[Demensions]
20x10

[TileDemensions]
64x64

[Textures]
Background\Road 64 64
Background\Water 64 64
Background\Dirt 64 64

[Entrances]
TileMaps\overworld.map

[TileLayer]
02|02|02|02|02|02|02|02|02|02|02|02|02|02|02|02|02|02|02|02
02|02|02|02|02|02|02|02|02|02|02|02|02|02|02|02|02|02|02|02
02|02|02|02|02|02|02|02|02|02|02|02|02|02|02|02|02|02|02|02
02|02|02|02|02|02|02|02|02|02|02|02|02|02|02|02|02|02|02|02
02|02|02|02|02|02|02|02|02|02|02|02|02|02|02|02|02|02|02|02
02|02|02|02|02|02|02|02|02|02|02|02|02|02|02|02|02|02|02|02
02|02|02|02|02|02|02|02|02|02|02|02|02|02|02|02|02|02|02|02
02|01|02|02|02|02|02|02|02|02|02|02|02|02|02|02|02|02|01|02
02|01|02|02|02|02|02|02|02|02|00|00|02|02|02|02|02|02|01|02
00|00|00|00|00|00|00|00|00|00|00|00|00|00|00|00|00|00|00|00

[CollisionLayer]
00|00|00|00|00|00|00|00|00|00|00|00|00|00|00|00|00|00|00|00
00|00|00|00|00|00|00|00|00|00|00|00|00|00|00|00|00|00|00|00
00|00|00|00|00|00|00|00|00|00|00|00|00|00|00|00|00|00|00|00
00|00|00|00|00|00|00|00|00|00|00|00|00|00|00|00|00|00|00|00
00|00|00|00|00|00|00|00|00|00|00|00|00|00|00|00|00|00|00|00
00|00|00|00|00|00|00|00|00|00|00|00|00|00|00|00|00|00|00|00
00|00|00|00|00|00|00|00|00|00|00|00|00|00|00|00|00|00|00|00
00|01|00|00|00|00|00|00|00|00|00|00|00|00|00|00|00|00|01|00
00|01|00|00|00|00|00|00|00|00|-1|-1|00|00|00|00|00|00|01|00
-1|-1|-1|-1|-1|-1|-1|-1|-1|-1|-1|-1|-1|-1|-1|-1|-1|-1|-1|-1
