[Demensions]
7x7

[TileDemensions]
64x64

[Textures]
Background\Dirt 64 64
Background\Water 64 64
Inside\Floors\Tile_Grey 64 64

[TileLayer]
01|01|01|01|01|01|01
01|01|02|02|02|01|01
01|01|02|02|02|01|01
01|01|01|02|01|01|01
01|01|01|02|01|01|01
01|01|01|02|01|01|01
01|01|01|02|01|01|01

[CollisionLayer]
-1|-2|-2|-2|-2|-2|-1
-1|-2|-1|-1|-1|-2|-1
-1|-2|-1|-1|-1|-2|-1
-1|-2|-2|-1|-2|-2|-1
-1|-1|-2|-1|-2|-1|-1
-1|-1|-2|-1|-2|-1|-1
-1|-1|-2|-1|-2|-1|-1
