[Type]
OverWorld

[Demensions]
7x7

[TileDemensions]
64x64

[Textures]
Background\Dirt 64 64
Background\Water 64 64
Inside\Floors\Tile_Grey 64 64
Dungeon\DungeonDoor 64 64

[Entrances]
TileMaps\overworld.map

[NPCs]
TecMan Centre 25 50

[TileLayer]
01|01|01|01|01|01|01
01|01|02|02|02|01|01
01|01|02|02|02|01|01
01|01|01|02|01|01|01
01|01|01|02|01|01|01
01|01|01|02|01|01|01
01|01|01|02|01|01|01

[TileLayer]
-1|-1|-1|-1|-1|-1|-1
-1|-1|03|-1|-1|-1|-1
-1|-1|-1|-1|-1|-1|-1
-1|-1|-1|-1|-1|-1|-1
-1|-1|-1|-1|-1|-1|-1
-1|-1|-1|-1|-1|-1|-1
-1|-1|-1|-1|-1|-1|-1

[CollisionLayer]
-1|-2|-2|-2|-2|-2|-1
-1|-2|00|-1|-1|-2|-1
-1|-2|-1|-1|-1|-2|-1
-1|-2|-2|-1|-2|-2|-1
-1|-1|-2|-1|-2|-1|-1
-1|-1|-2|-1|-2|-1|-1
-1|-1|-2|-3|-2|-1|-1

[NPCLayer]
-1|-1|-1|-1|-1|-1|-1
-1|-1|-1|-1|-1|-1|-1
-1|-1|-1|-1|00|-1|-1
-1|-1|-1|-1|-1|-1|-1
-1|-1|-1|-1|-1|-1|-1
-1|-1|-1|-1|-1|-1|-1
-1|-1|-1|-1|-1|-1|-1
