[Demensions]
50x50

[TileDemensions]
64x64

[Textures]
Background\Water 64 64
Background\Road 64 64
Background\Dirt 64 64
Dungeon\Start 64 64
Dungeon\Fin 64 64

[Entrances]

[TileLayer]
00|00|00|00|00|00|00|00|00|00|00|00|00|00|00|00|00|00|00|00|00|00|00|00|00|00|00|00|00|00|00|00|00|00|00|00|00|00|00|00|00|00|00|00|00|00|00|00|00|00
00|00|00|00|00|00|00|00|00|00|00|00|00|00|00|00|00|00|00|00|00|00|00|00|00|00|00|00|00|00|00|00|00|00|00|00|00|00|00|00|00|00|00|00|00|00|00|00|00|00
00|00|00|00|00|00|00|00|00|00|00|00|00|00|00|00|00|00|00|00|00|00|00|00|00|00|00|00|00|00|00|00|00|00|00|00|00|00|00|00|00|00|00|00|00|00|00|00|00|00
00|00|00|00|00|00|00|00|00|00|00|00|00|00|00|00|00|00|00|00|00|00|00|00|00|00|00|00|00|00|00|00|00|00|00|00|00|00|00|00|00|00|00|00|00|00|00|00|00|00
00|00|00|00|00|00|00|00|00|00|00|00|00|00|00|00|00|00|00|00|00|00|00|00|00|00|00|00|00|00|00|00|00|00|00|00|00|00|00|00|00|00|00|00|00|00|00|00|00|00
00|00|00|00|00|00|00|00|00|00|00|00|00|00|00|00|00|00|00|00|00|00|00|00|00|00|00|00|00|00|00|00|00|00|00|00|00|00|00|00|00|00|00|00|00|00|00|00|00|00
00|00|00|00|00|00|00|00|00|00|00|00|00|00|00|00|00|00|00|00|00|00|00|00|00|00|00|00|00|00|00|00|00|00|00|00|00|00|00|00|00|00|00|00|00|00|00|00|00|00
00|00|00|00|00|00|00|00|00|00|00|00|00|00|00|00|00|00|00|00|00|00|00|00|00|00|00|00|00|00|00|00|00|00|00|00|00|00|00|00|00|00|00|00|00|00|00|00|00|00
00|00|00|00|00|00|00|00|00|00|00|00|00|00|00|00|00|00|00|00|00|00|00|00|00|00|00|00|00|00|00|00|00|00|00|00|00|00|00|00|00|00|00|00|00|00|00|00|00|00
00|00|00|00|00|00|00|00|00|00|00|00|00|00|00|00|00|00|00|00|00|00|00|00|00|00|00|00|00|00|00|00|00|00|00|00|00|00|00|00|00|00|00|00|00|00|00|00|00|00
00|00|00|00|00|00|00|00|00|00|00|00|00|00|00|00|00|00|00|00|00|00|00|00|00|00|00|00|00|00|00|00|00|00|00|00|00|00|00|00|00|00|00|00|00|00|00|00|00|00
00|00|00|00|00|00|00|00|00|00|00|00|00|00|00|00|00|00|00|00|00|00|00|00|00|00|00|00|00|00|00|00|00|00|00|00|00|00|00|00|00|00|00|00|00|00|00|00|00|00
00|00|00|00|00|00|00|00|00|00|00|00|00|00|00|00|00|00|00|00|00|00|00|00|00|00|00|00|00|00|00|00|00|00|00|00|00|00|00|00|00|00|00|00|00|00|00|00|00|00
00|00|00|00|00|00|00|00|00|00|00|00|00|00|00|00|00|00|00|00|00|00|00|00|00|00|00|00|00|00|00|00|00|00|00|00|00|00|00|00|00|00|00|00|00|00|00|00|00|00
00|00|00|00|00|00|00|00|00|00|00|00|00|00|00|00|00|00|00|00|00|00|00|00|00|00|00|00|00|00|00|00|00|00|00|00|00|00|00|00|00|00|00|00|00|00|00|00|00|00
00|00|00|00|00|00|00|00|00|00|00|00|00|00|00|00|00|00|00|00|00|00|00|00|00|00|00|00|00|00|00|00|00|00|00|00|00|00|00|00|00|00|00|00|00|00|00|00|00|00
00|00|00|00|00|00|00|00|00|00|00|00|00|00|00|00|00|00|00|00|00|00|00|00|00|00|00|00|00|00|00|00|00|00|00|00|00|00|00|00|00|00|00|00|00|00|00|00|00|00
00|00|00|00|00|00|00|00|00|00|00|00|00|00|00|00|00|00|00|00|00|00|00|00|00|00|00|00|00|00|00|00|00|00|00|00|00|00|00|00|00|00|00|00|00|00|00|00|00|00
00|00|00|00|00|00|00|00|00|00|00|00|00|00|00|00|00|00|00|00|00|00|00|00|00|00|00|00|00|00|00|00|00|00|00|00|00|00|00|00|00|00|00|00|00|00|00|00|00|00
00|00|00|00|00|00|00|00|00|00|00|00|00|00|00|00|00|00|00|00|00|00|00|00|00|00|00|00|00|00|00|00|00|00|00|00|00|00|00|00|00|00|00|00|00|00|00|00|00|00
00|00|00|00|00|00|00|00|00|00|00|00|00|00|00|00|00|00|00|00|00|00|00|00|00|00|00|00|00|00|00|00|00|00|00|00|00|00|00|00|00|00|00|00|00|00|00|00|00|00
00|00|00|00|00|00|00|00|00|00|00|00|00|00|00|00|00|00|00|00|00|00|00|00|00|00|00|00|00|00|00|00|00|00|00|00|00|00|00|00|00|00|00|00|00|00|00|00|00|00
00|00|00|00|00|00|00|00|00|00|00|00|00|00|00|00|00|00|00|00|00|00|00|00|00|00|00|00|00|00|00|00|00|00|00|00|00|00|00|00|00|00|00|00|00|00|00|00|00|00
00|00|00|00|00|00|00|00|00|00|00|00|00|00|00|00|00|00|00|00|00|00|00|00|00|00|00|00|00|00|00|00|00|00|00|00|00|00|00|00|00|00|00|00|00|00|00|00|00|00
00|00|00|00|00|00|00|00|00|00|00|00|00|00|00|00|00|00|00|00|00|00|00|00|00|00|00|00|00|00|00|00|00|00|00|00|00|00|00|00|00|00|00|00|00|00|00|00|00|00
00|00|00|00|00|00|00|00|00|00|00|00|00|00|00|00|00|00|00|00|00|00|00|00|00|00|00|00|00|00|00|00|00|00|00|00|00|00|00|00|00|00|00|00|00|00|00|00|00|00
00|00|00|00|00|00|00|00|00|00|00|00|00|00|00|00|00|00|00|00|00|00|00|00|00|00|00|00|00|00|00|00|00|00|00|00|00|00|00|00|00|00|00|00|00|00|00|00|00|00
00|00|00|00|00|00|00|00|00|00|00|00|00|00|00|00|00|00|00|00|00|00|00|00|00|00|00|00|00|00|00|00|00|00|00|00|00|00|00|00|00|00|00|00|00|00|00|00|00|00
00|00|00|00|00|00|00|00|00|00|00|00|00|00|00|00|00|00|00|00|00|00|00|00|00|00|00|00|00|00|00|00|00|00|00|00|00|00|00|00|00|00|00|00|00|00|00|00|00|00
00|00|00|00|00|00|00|00|00|00|00|00|00|00|00|00|00|00|00|00|00|00|00|00|00|00|00|00|00|00|00|00|00|00|00|00|00|00|00|00|00|00|00|00|00|00|00|00|00|00
00|00|00|00|00|00|00|00|00|00|00|00|00|00|00|00|00|00|00|00|00|00|00|00|00|00|00|00|00|00|00|00|00|00|00|00|00|00|00|00|00|00|00|00|00|00|00|00|00|00
00|00|00|00|00|00|00|00|00|00|00|00|00|00|00|00|00|00|00|00|00|00|00|00|00|00|00|00|00|00|00|00|00|00|00|00|00|00|00|00|00|00|00|00|00|00|00|00|00|00
00|00|00|00|00|00|00|00|00|00|00|00|00|00|00|00|00|00|00|00|00|00|00|00|00|00|00|00|00|00|00|00|00|00|00|00|00|00|00|00|00|00|00|00|00|00|00|00|00|00
00|00|00|00|00|00|00|00|00|00|00|00|00|00|00|00|00|00|00|00|00|00|00|00|00|00|00|00|00|00|00|00|00|00|00|00|00|00|00|00|00|00|00|00|00|00|00|00|00|00
00|00|00|00|00|00|00|00|00|00|00|00|00|00|00|00|00|00|00|00|00|00|00|00|00|00|00|00|00|00|00|00|00|00|00|00|00|00|00|00|00|00|00|00|00|00|00|00|00|00
00|00|00|00|00|00|00|00|00|00|00|00|00|00|00|00|00|00|00|00|00|00|00|00|00|00|00|00|00|00|00|00|00|00|00|00|00|00|00|00|00|00|00|00|00|00|00|00|00|00
00|00|00|00|00|00|00|00|00|00|00|00|00|00|00|00|00|00|00|00|00|00|00|00|00|00|00|00|00|00|00|00|00|00|00|00|00|00|00|00|00|00|00|00|00|00|00|00|00|00
00|00|00|00|00|00|00|00|00|00|00|00|00|00|00|00|00|00|00|00|00|00|00|00|00|00|00|00|00|00|00|00|00|00|00|00|00|00|00|00|00|00|00|00|00|00|00|00|00|00
00|00|00|00|00|00|00|00|00|00|00|00|00|00|00|00|00|00|00|00|00|00|00|00|00|00|00|00|00|00|00|00|00|00|00|00|00|00|00|00|00|00|00|00|00|00|00|00|00|00
00|00|00|00|00|00|00|00|00|00|00|00|00|00|00|00|00|00|00|00|00|00|00|00|00|00|00|00|00|00|00|00|00|00|00|00|00|00|00|00|00|00|00|00|00|00|00|00|00|00
00|00|00|00|00|00|00|00|00|00|00|00|00|00|00|00|00|00|00|00|00|00|00|00|00|00|00|00|00|00|00|00|00|00|00|00|00|00|00|00|00|00|00|00|00|00|00|00|00|00
00|00|00|00|00|00|00|00|00|00|00|00|00|00|00|00|00|00|00|00|00|00|00|00|00|00|00|00|00|00|00|00|00|00|00|00|00|00|00|00|00|00|00|00|00|00|00|00|00|00
00|00|00|00|00|00|00|00|00|00|00|00|00|00|00|00|00|00|00|00|00|00|00|00|00|00|00|00|00|00|00|00|00|00|00|00|00|00|00|00|00|00|00|00|00|00|00|00|00|00
00|00|00|00|00|00|00|00|00|00|00|00|00|00|00|00|00|00|00|00|00|00|00|00|00|00|00|00|00|00|00|00|00|00|00|00|00|00|00|00|00|00|00|00|00|00|00|00|00|00
00|00|00|00|00|00|00|00|00|00|00|00|00|00|00|00|00|00|00|00|00|00|00|00|00|00|00|00|00|00|00|00|00|00|00|00|00|00|00|00|00|00|00|00|00|00|00|00|00|00
00|00|00|00|00|00|00|00|00|00|00|00|00|00|00|00|00|00|00|00|00|00|00|00|00|00|00|00|00|00|00|00|00|00|00|00|00|00|00|00|00|00|00|00|00|00|00|00|00|00
00|00|00|00|00|00|00|00|00|00|00|00|00|00|00|00|00|00|00|00|00|00|00|00|00|00|00|00|00|00|00|00|00|00|00|00|00|00|00|00|00|00|00|00|00|00|00|00|00|00
00|00|00|00|00|00|00|00|00|00|00|00|00|00|00|00|00|00|00|00|00|00|00|00|00|00|00|00|00|00|00|00|00|00|00|00|00|00|00|00|00|00|00|00|00|00|00|00|00|00
00|00|00|00|00|00|00|00|00|00|00|00|00|00|00|00|00|00|00|00|00|00|00|00|00|00|00|00|00|00|00|00|00|00|00|00|00|00|00|00|00|00|00|00|00|00|00|00|00|00
00|00|00|00|00|00|00|00|00|00|00|00|00|00|00|00|00|00|00|00|00|00|00|00|00|00|00|00|00|00|00|00|00|00|00|00|00|00|00|00|00|00|00|00|00|00|00|00|00|00

[TileLayer]
01|01|01|01|01|01|01|01|01|01|01|01|01|01|01|01|01|01|01|02|02|02|01|01|01|01|01|02|01|01|01|01|01|01|01|01|01|01|01|01|01|01|01|01|01|01|01|01|01|01
03|-1|-1|-1|-1|-1|-1|-1|-1|-1|-1|-1|-1|-1|-1|-1|-1|-1|01|02|02|02|02|02|01|02|02|02|01|-1|-1|-1|-1|-1|-1|-1|-1|-1|-1|-1|-1|-1|-1|-1|-1|-1|-1|-1|04|01
01|01|01|01|01|01|01|01|01|-1|-1|01|-1|-1|-1|-1|-1|-1|01|02|02|02|02|02|01|02|02|02|01|-1|-1|-1|-1|-1|-1|-1|-1|-1|-1|-1|-1|-1|-1|-1|-1|-1|-1|-1|-1|01
01|01|01|01|01|01|01|01|01|-1|-1|01|-1|-1|01|01|-1|-1|01|02|02|02|02|02|01|02|02|02|01|-1|-1|-1|-1|-1|-1|-1|-1|-1|-1|-1|-1|-1|-1|-1|-1|-1|-1|-1|-1|01
01|-1|-1|-1|-1|-1|-1|-1|-1|-1|-1|-1|-1|01|01|01|-1|-1|01|02|01|02|02|02|01|02|02|02|01|-1|-1|-1|-1|-1|-1|-1|-1|-1|-1|-1|-1|-1|-1|-1|-1|-1|-1|-1|-1|01
01|01|01|01|01|01|01|01|01|01|01|01|01|01|01|01|-1|-1|01|02|01|01|02|02|01|02|02|02|01|-1|-1|-1|-1|-1|-1|-1|-1|-1|-1|-1|-1|-1|-1|-1|-1|-1|-1|-1|-1|01
01|-1|-1|-1|-1|-1|-1|-1|-1|-1|-1|-1|-1|-1|-1|-1|-1|-1|01|02|02|01|01|01|01|02|02|02|01|-1|-1|-1|-1|-1|-1|-1|-1|-1|-1|-1|-1|-1|-1|-1|-1|-1|-1|-1|-1|01
01|-1|01|01|01|01|01|01|01|01|01|01|01|01|01|01|01|01|01|01|01|01|01|01|01|01|01|01|01|-1|-1|-1|-1|-1|-1|-1|-1|-1|-1|-1|-1|-1|-1|-1|-1|-1|-1|-1|-1|01
01|-1|-1|-1|-1|-1|-1|-1|-1|-1|-1|-1|-1|-1|-1|-1|-1|-1|01|02|02|02|02|01|02|02|02|02|01|-1|-1|-1|-1|-1|-1|-1|-1|-1|-1|-1|-1|-1|-1|-1|-1|-1|-1|-1|-1|01
01|-1|-1|-1|-1|-1|-1|-1|-1|-1|-1|-1|-1|-1|-1|-1|-1|-1|01|02|02|02|01|01|01|02|02|02|01|-1|-1|-1|-1|-1|-1|-1|-1|-1|-1|-1|-1|-1|-1|-1|-1|-1|-1|-1|-1|01
01|01|01|-1|-1|01|01|01|-1|-1|01|01|01|01|01|-1|01|01|01|02|02|01|01|02|01|01|02|02|01|-1|-1|-1|-1|-1|-1|-1|-1|-1|-1|-1|-1|-1|-1|-1|-1|-1|-1|-1|-1|01
01|-1|-1|-1|01|01|-1|-1|-1|-1|-1|-1|-1|-1|01|-1|01|01|01|02|01|01|02|02|02|01|01|02|01|-1|-1|-1|-1|-1|-1|-1|-1|-1|-1|-1|-1|-1|-1|-1|-1|-1|-1|-1|-1|01
01|-1|-1|01|01|01|-1|01|01|01|01|01|-1|01|01|-1|01|01|01|02|01|01|01|01|01|01|01|02|01|-1|-1|-1|-1|-1|-1|-1|-1|-1|-1|-1|-1|-1|-1|-1|-1|-1|-1|-1|-1|01
01|-1|01|01|01|01|-1|01|01|01|01|01|-1|01|01|-1|01|01|01|02|01|02|02|02|02|02|01|02|01|-1|-1|-1|-1|-1|-1|-1|-1|-1|-1|-1|-1|-1|-1|-1|-1|-1|-1|-1|-1|01
01|-1|01|01|01|-1|-1|-1|-1|-1|-1|-1|-1|-1|01|-1|01|01|01|02|01|02|02|02|02|02|01|02|01|-1|-1|-1|-1|-1|-1|-1|-1|-1|-1|-1|-1|-1|-1|-1|-1|-1|-1|-1|-1|01
01|-1|-1|-1|-1|-1|01|01|01|01|01|01|01|01|01|-1|01|01|01|01|01|01|01|01|01|01|01|01|01|01|01|01|01|01|01|01|01|01|01|01|01|01|01|01|01|01|-1|-1|-1|01
01|01|01|01|01|01|01|01|01|01|01|01|01|01|01|-1|-1|-1|-1|-1|-1|-1|-1|-1|-1|-1|-1|-1|-1|-1|-1|-1|-1|-1|-1|-1|-1|01|01|01|01|01|01|01|01|01|01|-1|-1|01
01|01|01|01|01|01|01|01|01|01|01|01|01|01|01|01|01|01|01|01|01|01|01|01|01|01|01|01|01|01|01|01|01|01|01|01|-1|01|01|01|01|01|-1|-1|-1|-1|-1|-1|-1|01
01|01|01|01|01|01|01|01|01|01|01|01|01|01|01|01|01|01|01|02|01|02|02|02|02|02|01|02|01|-1|-1|-1|-1|-1|-1|-1|-1|01|01|01|01|01|-1|-1|-1|-1|-1|-1|01|01
01|01|01|01|01|01|01|01|01|01|01|01|01|01|01|01|01|01|01|02|01|02|02|02|02|02|01|02|01|-1|-1|-1|-1|-1|-1|-1|-1|01|01|01|01|01|-1|-1|-1|-1|-1|01|01|01
01|01|01|01|01|01|01|01|01|01|01|01|01|01|01|01|01|01|01|02|01|01|02|02|02|01|01|02|01|-1|01|01|01|01|01|01|01|01|01|01|01|01|-1|-1|-1|-1|01|01|01|01
01|01|01|01|01|01|01|01|01|01|01|01|01|01|01|01|01|01|01|02|02|01|02|02|02|01|02|02|01|-1|-1|-1|-1|-1|-1|-1|-1|01|01|01|01|01|-1|-1|-1|01|01|01|01|01
01|01|01|01|01|01|01|01|01|01|01|01|01|01|01|01|01|01|01|02|02|01|01|02|01|01|02|02|01|-1|-1|-1|-1|-1|-1|-1|-1|01|01|01|01|01|-1|-1|01|01|01|01|01|01
01|01|01|01|01|01|01|01|01|01|01|01|01|01|01|01|01|01|01|02|02|02|01|01|01|02|02|02|01|01|01|01|01|01|01|01|-1|01|01|01|01|01|-1|-1|-1|01|01|01|01|01
01|01|01|01|01|01|01|01|01|01|01|01|01|01|01|01|01|01|01|02|02|02|02|01|02|02|02|02|01|-1|-1|-1|-1|-1|-1|-1|-1|01|01|01|01|01|01|-1|-1|-1|-1|-1|-1|01
01|01|01|01|01|01|01|01|01|01|01|01|01|01|01|01|01|01|01|01|01|01|01|01|01|01|01|01|01|-1|-1|-1|-1|-1|-1|-1|-1|01|01|01|01|01|01|01|-1|-1|-1|-1|-1|01
01|-1|-1|-1|-1|-1|-1|-1|-1|-1|-1|-1|-1|-1|-1|-1|-1|-1|-1|-1|-1|-1|-1|-1|-1|-1|-1|-1|-1|-1|01|01|01|01|01|01|01|01|01|01|01|01|01|01|01|-1|-1|-1|-1|01
01|-1|-1|-1|-1|-1|-1|-1|-1|-1|-1|-1|-1|-1|-1|-1|-1|-1|01|01|01|01|01|01|01|01|01|01|01|01|01|01|01|01|01|01|01|01|01|01|01|01|01|01|01|01|01|-1|-1|01
01|-1|01|01|01|01|01|01|01|01|01|01|01|01|01|01|01|01|01|02|02|02|02|01|02|02|02|02|01|01|01|01|01|01|01|01|01|01|01|01|01|01|01|01|01|01|01|-1|-1|01
01|-1|-1|-1|-1|-1|-1|-1|-1|-1|-1|-1|-1|-1|-1|-1|-1|-1|01|02|02|02|01|01|01|02|02|02|01|01|01|01|01|01|01|01|01|01|01|01|01|01|01|01|01|01|-1|-1|01|01
01|-1|-1|-1|-1|-1|-1|-1|-1|-1|-1|-1|-1|-1|-1|-1|-1|-1|01|02|02|01|01|02|01|01|02|02|01|01|01|01|01|01|01|01|01|01|01|01|01|01|01|01|01|-1|-1|-1|01|01
01|01|01|01|01|01|01|01|01|01|01|01|01|01|01|01|-1|-1|01|02|01|01|02|02|02|01|01|02|01|01|01|01|01|01|01|01|01|01|01|01|01|01|01|01|-1|-1|-1|01|01|01
01|01|01|01|01|01|01|01|01|01|01|01|01|01|01|01|-1|-1|01|02|01|01|01|01|01|01|01|02|01|01|01|01|01|01|01|01|01|01|01|01|01|01|01|-1|-1|-1|01|01|01|01
01|01|01|01|01|01|01|01|01|01|01|01|01|01|01|01|-1|-1|01|02|01|02|02|02|02|02|01|02|01|01|01|01|01|01|01|01|01|01|01|01|01|-1|-1|-1|-1|01|01|01|01|01
01|-1|-1|-1|-1|-1|-1|-1|-1|-1|-1|-1|-1|-1|-1|-1|-1|-1|01|02|01|02|02|02|02|02|01|02|01|01|01|01|01|01|01|01|01|-1|-1|-1|-1|-1|-1|-1|01|01|01|01|01|01
01|-1|-1|-1|-1|-1|-1|-1|-1|-1|-1|-1|-1|-1|-1|-1|-1|-1|01|01|01|01|01|01|01|01|01|01|01|01|01|01|01|01|01|01|-1|-1|-1|-1|-1|-1|01|01|01|01|01|01|01|01
01|-1|01|01|01|01|01|01|01|01|01|01|01|01|01|01|01|01|01|01|01|01|01|01|01|01|01|01|01|-1|-1|-1|-1|-1|-1|-1|-1|-1|01|01|01|01|01|01|01|02|02|01|02|01
01|-1|01|01|01|01|01|01|01|01|01|01|01|01|01|01|01|01|01|01|01|01|01|01|01|01|01|01|01|-1|-1|-1|-1|-1|-1|-1|-1|01|01|01|01|01|01|01|01|02|02|01|02|01
01|-1|01|01|01|01|01|01|01|01|01|01|01|01|01|01|01|01|01|01|01|01|01|01|01|-1|-1|-1|-1|-1|-1|01|01|01|01|01|01|01|01|01|01|01|01|02|01|02|02|01|02|01
01|-1|01|01|01|01|01|01|01|01|01|01|01|01|01|01|01|01|01|-1|-1|-1|-1|-1|-1|-1|-1|-1|-1|-1|01|01|01|01|01|01|01|01|01|01|01|01|01|02|01|02|02|01|02|01
01|-1|01|01|01|01|01|01|01|01|-1|-1|-1|-1|-1|-1|-1|-1|-1|-1|-1|-1|-1|-1|-1|-1|01|01|01|01|01|01|01|01|01|02|02|02|02|01|02|02|01|02|02|02|02|01|02|01
01|-1|01|01|01|01|01|01|01|01|-1|-1|-1|-1|-1|-1|-1|-1|-1|-1|-1|01|01|01|01|01|01|01|01|01|01|01|01|02|01|01|02|02|02|01|02|02|01|02|02|02|02|02|02|01
01|-1|-1|-1|-1|-1|-1|-1|-1|-1|-1|-1|-1|-1|01|01|01|01|01|01|01|01|01|01|01|01|01|01|01|01|01|02|01|02|01|02|02|02|02|01|02|02|01|02|02|02|02|02|02|01
01|-1|-1|-1|-1|-1|-1|-1|-1|-1|-1|01|01|01|01|01|01|01|01|01|01|01|01|01|01|01|01|01|02|02|01|02|01|02|01|02|01|01|02|01|02|02|02|02|02|02|02|02|02|01
01|01|01|01|01|01|01|01|01|01|01|01|01|01|02|02|01|02|02|01|02|02|02|01|02|02|02|01|02|02|01|02|01|02|01|02|01|01|02|01|02|02|02|02|02|02|02|02|02|01
01|01|01|01|01|01|01|01|01|01|01|01|01|01|02|02|01|02|02|01|02|02|02|01|02|02|02|01|02|02|01|02|02|02|01|02|02|01|02|01|02|02|02|02|02|02|02|02|02|01
02|01|02|02|01|02|02|02|01|02|02|01|02|01|02|02|01|02|02|01|02|02|02|01|02|02|02|01|02|02|02|02|02|02|02|02|02|02|02|01|02|02|02|02|02|02|02|02|02|01
02|01|02|02|01|02|02|02|01|02|02|01|02|01|02|02|02|02|02|02|02|02|02|01|02|02|02|02|02|01|02|02|02|02|02|02|02|02|02|02|02|02|02|02|02|02|02|02|02|01
02|02|02|02|01|02|02|02|02|02|02|02|02|01|02|02|02|02|02|01|02|02|02|02|02|01|02|02|02|02|02|02|01|02|02|02|01|02|02|02|02|02|01|02|02|02|02|02|02|01
02|02|02|02|02|02|02|02|02|02|02|02|02|02|02|02|02|01|02|02|02|01|02|02|02|02|02|02|02|02|02|02|02|02|02|02|02|02|02|02|02|02|02|02|02|02|02|02|02|01

[CollisionLayer]
-1|-1|-1|-1|-1|-1|-1|-1|-1|-1|-1|-1|-1|-1|-1|-1|-1|-1|-1|00|00|00|00|00|00|00|00|00|-1|-1|-1|-1|-1|-1|-1|-1|-1|-1|-1|-1|-1|-1|-1|-1|-1|-1|-1|-1|-1|-1
-1|00|00|00|00|00|00|00|00|00|00|00|00|00|00|00|00|00|-1|00|00|00|00|00|00|00|00|00|-1|00|00|00|00|00|00|00|00|00|00|00|00|00|00|00|00|00|00|00|-1|-1
-1|-1|-1|-1|-1|-1|-1|-1|-1|00|00|-1|00|00|00|00|00|00|-1|00|00|00|00|00|00|00|00|00|-1|00|00|00|00|00|00|00|00|00|00|00|00|00|00|00|00|00|00|00|00|-1
-1|-1|-1|-1|-1|-1|-1|-1|-1|00|00|-1|00|00|-1|-1|00|00|-1|00|00|00|00|00|00|00|00|00|-1|00|00|00|00|00|00|00|00|00|00|00|00|00|00|00|00|00|00|00|00|-1
-1|00|00|00|00|00|00|00|00|00|00|00|00|-1|-1|-1|00|00|-1|00|00|00|00|00|00|00|00|00|-1|00|00|00|00|00|00|00|00|00|00|00|00|00|00|00|00|00|00|00|00|-1
-1|-1|-1|-1|-1|-1|-1|-1|-1|-1|-1|-1|-1|-1|-1|-1|00|00|-1|00|00|00|00|00|00|00|00|00|-1|00|00|00|00|00|00|00|00|00|00|00|00|00|00|00|00|00|00|00|00|-1
-1|00|00|00|00|00|00|00|00|00|00|00|00|00|00|00|00|00|-1|00|00|00|00|00|00|00|00|00|-1|00|00|00|00|00|00|00|00|00|00|00|00|00|00|00|00|00|00|00|00|-1
-1|00|-1|-1|-1|-1|-1|-1|-1|-1|-1|-1|-1|-1|-1|-1|-1|-1|-1|00|00|00|00|00|00|00|00|00|-1|00|00|00|00|00|00|00|00|00|00|00|00|00|00|00|00|00|00|00|00|-1
-1|00|00|00|00|00|00|00|00|00|00|00|00|00|00|00|00|00|-1|00|00|00|00|00|00|00|00|00|-1|00|00|00|00|00|00|00|00|00|00|00|00|00|00|00|00|00|00|00|00|-1
-1|00|00|00|00|00|00|00|00|00|00|00|00|00|00|00|00|00|-1|00|00|00|00|00|00|00|00|00|-1|00|00|00|00|00|00|00|00|00|00|00|00|00|00|00|00|00|00|00|00|-1
-1|-1|-1|00|00|-1|-1|-1|00|00|-1|-1|-1|-1|-1|00|-1|-1|-1|00|00|00|00|00|00|00|00|00|-1|00|00|00|00|00|00|00|00|00|00|00|00|00|00|00|00|00|00|00|00|-1
-1|00|00|00|-1|-1|00|00|00|00|00|00|00|00|-1|00|-1|00|00|00|00|00|00|00|00|00|00|00|-1|00|00|00|00|00|00|00|00|00|00|00|00|00|00|00|00|00|00|00|00|-1
-1|00|00|-1|-1|-1|00|-1|-1|-1|-1|-1|00|-1|-1|00|-1|00|00|00|00|00|00|00|00|00|00|00|-1|00|00|00|00|00|00|00|00|00|00|00|00|00|00|00|00|00|00|00|00|-1
-1|00|-1|-1|-1|-1|00|-1|-1|-1|-1|-1|00|-1|-1|00|-1|00|00|00|00|00|00|00|00|00|00|00|-1|00|00|00|00|00|00|00|00|00|00|00|00|00|00|00|00|00|00|00|00|-1
-1|00|-1|-1|-1|00|00|00|00|00|00|00|00|00|-1|00|-1|00|00|00|00|00|00|00|00|00|00|00|-1|00|00|00|00|00|00|00|00|00|00|00|00|00|00|00|00|00|00|00|00|-1
-1|00|00|00|00|00|-1|-1|-1|-1|-1|-1|-1|-1|-1|00|-1|-1|-1|-1|-1|-1|-1|-1|-1|-1|-1|-1|-1|-1|-1|-1|-1|-1|-1|-1|-1|-1|-1|-1|-1|-1|-1|-1|-1|-1|00|00|00|-1
-1|-1|-1|-1|-1|-1|-1|00|00|00|00|00|00|00|-1|00|00|00|00|00|00|00|00|00|00|00|00|00|00|00|00|00|00|00|00|00|00|-1|00|00|00|-1|-1|-1|-1|-1|-1|00|00|-1
00|00|00|00|00|00|00|00|00|00|00|00|00|00|-1|-1|-1|-1|-1|-1|-1|-1|-1|-1|-1|-1|-1|-1|-1|-1|-1|-1|-1|-1|-1|-1|00|-1|00|00|00|-1|00|00|00|00|00|00|00|-1
00|00|00|00|00|00|00|00|00|00|00|00|00|00|00|00|00|00|00|00|00|00|00|00|00|00|00|00|-1|00|00|00|00|00|00|00|00|-1|00|00|00|-1|00|00|00|00|00|00|-1|-1
00|00|00|00|00|00|00|00|00|00|00|00|00|00|00|00|00|00|00|00|00|00|00|00|00|00|00|00|-1|00|00|00|00|00|00|00|00|-1|00|00|00|-1|00|00|00|00|00|-1|-1|00
00|00|00|00|00|00|00|00|00|00|00|00|00|00|00|00|00|00|00|00|00|00|00|00|00|00|00|00|-1|00|-1|-1|-1|-1|-1|-1|-1|-1|00|00|00|-1|00|00|00|00|-1|-1|00|00
00|00|00|00|00|00|00|00|00|00|00|00|00|00|00|00|00|00|00|00|00|00|00|00|00|00|00|00|-1|00|00|00|00|00|00|00|00|-1|00|00|00|-1|00|00|00|-1|-1|00|00|00
00|00|00|00|00|00|00|00|00|00|00|00|00|00|00|00|00|00|00|00|00|00|00|00|00|00|00|00|-1|00|00|00|00|00|00|00|00|-1|00|00|00|-1|00|00|-1|-1|00|00|00|00
00|00|00|00|00|00|00|00|00|00|00|00|00|00|00|00|00|00|00|00|00|00|00|00|00|00|00|00|-1|-1|-1|-1|-1|-1|-1|-1|00|-1|00|00|00|-1|00|00|00|-1|-1|-1|-1|-1
00|00|00|00|00|00|00|00|00|00|00|00|00|00|00|00|00|00|00|00|00|00|00|00|00|00|00|00|-1|00|00|00|00|00|00|00|00|-1|00|00|00|-1|-1|00|00|00|00|00|00|-1
-1|-1|-1|-1|-1|-1|-1|-1|-1|-1|-1|-1|-1|-1|-1|-1|-1|-1|-1|-1|-1|-1|-1|-1|-1|-1|-1|-1|-1|00|00|00|00|00|00|00|00|-1|00|00|00|00|-1|-1|00|00|00|00|00|-1
-1|00|00|00|00|00|00|00|00|00|00|00|00|00|00|00|00|00|00|00|00|00|00|00|00|00|00|00|00|00|-1|-1|-1|-1|-1|-1|-1|-1|00|00|00|00|00|-1|-1|00|00|00|00|-1
-1|00|00|00|00|00|00|00|00|00|00|00|00|00|00|00|00|00|-1|-1|-1|-1|-1|-1|-1|-1|-1|-1|-1|-1|-1|00|00|00|00|00|00|00|00|00|00|00|00|00|-1|-1|-1|00|00|-1
-1|00|-1|-1|-1|-1|-1|-1|-1|-1|-1|-1|-1|-1|-1|-1|-1|-1|-1|00|00|00|00|00|00|00|00|00|00|00|00|00|00|00|00|00|00|00|00|00|00|00|00|00|00|-1|-1|00|00|-1
-1|00|00|00|00|00|00|00|00|00|00|00|00|00|00|00|00|00|-1|00|00|00|00|00|00|00|00|00|00|00|00|00|00|00|00|00|00|00|00|00|00|00|00|00|-1|-1|00|00|-1|-1
-1|00|00|00|00|00|00|00|00|00|00|00|00|00|00|00|00|00|-1|00|00|00|00|00|00|00|00|00|00|00|00|00|00|00|00|00|00|00|00|00|00|00|00|-1|-1|00|00|00|-1|00
-1|-1|-1|-1|-1|-1|-1|-1|-1|-1|-1|-1|-1|-1|-1|-1|00|00|-1|00|00|00|00|00|00|00|00|00|00|00|00|00|00|00|00|00|00|00|00|00|00|00|-1|-1|00|00|00|-1|-1|00
00|00|00|00|00|00|00|00|00|00|00|00|00|00|00|-1|00|00|-1|00|00|00|00|00|00|00|00|00|00|00|00|00|00|00|00|00|00|00|00|00|-1|-1|-1|00|00|00|-1|-1|00|00
-1|-1|-1|-1|-1|-1|-1|-1|-1|-1|-1|-1|-1|-1|-1|-1|00|00|-1|00|00|00|00|00|00|00|00|00|00|00|00|00|00|00|00|00|-1|-1|-1|-1|-1|00|00|00|00|-1|-1|00|00|00
-1|00|00|00|00|00|00|00|00|00|00|00|00|00|00|00|00|00|-1|00|00|00|00|00|00|00|00|00|00|00|00|00|00|00|00|-1|-1|00|00|00|00|00|00|00|-1|-1|00|00|00|00
-1|00|00|00|00|00|00|00|00|00|00|00|00|00|00|00|00|00|-1|00|00|00|00|00|00|00|00|00|-1|-1|-1|-1|-1|-1|-1|-1|00|00|00|00|00|00|-1|-1|-1|00|00|00|00|00
-1|00|-1|-1|-1|-1|-1|-1|-1|-1|-1|-1|-1|-1|-1|-1|-1|-1|-1|00|00|00|00|00|00|00|00|00|-1|00|00|00|00|00|00|00|00|00|-1|-1|-1|-1|-1|00|00|00|00|00|00|00
-1|00|-1|00|00|00|00|00|00|00|00|00|00|00|00|00|00|00|00|00|00|00|00|00|-1|-1|-1|-1|-1|00|00|00|00|00|00|00|00|-1|-1|00|00|00|00|00|00|00|00|00|00|00
-1|00|-1|00|00|00|00|00|00|00|00|00|00|00|00|00|00|00|-1|-1|-1|-1|-1|-1|-1|00|00|00|00|00|00|-1|-1|-1|-1|-1|-1|-1|00|00|00|00|00|00|00|00|00|00|00|00
-1|00|-1|00|00|00|00|00|00|-1|-1|-1|-1|-1|-1|-1|-1|-1|-1|00|00|00|00|00|00|00|00|00|00|00|-1|-1|00|00|00|00|00|00|00|00|00|00|00|00|00|00|00|00|00|00
-1|00|-1|00|00|00|00|00|00|-1|00|00|00|00|00|00|00|00|00|00|00|00|00|00|00|00|-1|-1|-1|-1|-1|00|00|00|00|00|00|00|00|00|00|00|00|00|00|00|00|00|00|00
-1|00|-1|-1|-1|-1|-1|-1|-1|-1|00|00|00|00|00|00|00|00|00|00|00|-1|-1|-1|-1|-1|-1|00|00|00|00|00|00|00|00|00|00|00|00|00|00|00|00|00|00|00|00|00|00|00
-1|00|00|00|00|00|00|00|00|00|00|00|00|00|-1|-1|-1|-1|-1|-1|-1|-1|00|00|00|00|00|00|00|00|00|00|00|00|00|00|00|00|00|00|00|00|00|00|00|00|00|00|00|00
-1|00|00|00|00|00|00|00|00|00|00|-1|-1|-1|-1|00|00|00|00|00|00|00|00|00|00|00|00|00|00|00|00|00|00|00|00|00|00|00|00|00|00|00|00|00|00|00|00|00|00|00
-1|-1|-1|-1|-1|-1|-1|-1|-1|-1|-1|-1|00|00|00|00|00|00|00|00|00|00|00|00|00|00|00|00|00|00|00|00|00|00|00|00|00|00|00|00|00|00|00|00|00|00|00|00|00|00
00|00|00|00|00|00|00|00|00|00|00|00|00|00|00|00|00|00|00|00|00|00|00|00|00|00|00|00|00|00|00|00|00|00|00|00|00|00|00|00|00|00|00|00|00|00|00|00|00|00
00|00|00|00|00|00|00|00|00|00|00|00|00|00|00|00|00|00|00|00|00|00|00|00|00|00|00|00|00|00|00|00|00|00|00|00|00|00|00|00|00|00|00|00|00|00|00|00|00|00
00|00|00|00|00|00|00|00|00|00|00|00|00|00|00|00|00|00|00|00|00|00|00|00|00|00|00|00|00|00|00|00|00|00|00|00|00|00|00|00|00|00|00|00|00|00|00|00|00|00
00|00|00|00|00|00|00|00|00|00|00|00|00|00|00|00|00|00|00|00|00|00|00|00|00|00|00|00|00|00|00|00|00|00|00|00|00|00|00|00|00|00|00|00|00|00|00|00|00|00
00|00|00|00|00|00|00|00|00|00|00|00|00|00|00|00|00|00|00|00|00|00|00|00|00|00|00|00|00|00|00|00|00|00|00|00|00|00|00|00|00|00|00|00|00|00|00|00|00|00
