[Type]
Dungeon

[Demensions]
40x40

[TileDemensions]
64x64

[Textures]
Background\Road 64 64
Background\Dirt 64 64
Inside\Floors\Tile_Grey 64 64
Inside\Floors\Wood 64 64
Dungeon\Fin 64 64
Dungeon\Start 64 64

[Entrances]
TileMaps\D2End.map

[TileLayer]
01|02|02|02|02|02|02|02|02|02|02|02|02|02|02|02|02|02|02|02|02|02|02|02|02|02|02|02|02|02|02|02|02|02|02|02|02|02|02|02
02|02|02|02|02|02|02|02|02|02|02|02|02|02|02|02|02|02|02|02|02|02|02|02|02|02|02|02|02|02|02|02|02|02|02|02|02|02|02|02
02|02|02|02|02|02|02|02|02|02|02|02|02|02|02|02|02|02|02|02|02|02|02|02|02|02|02|02|02|02|02|02|02|02|02|02|02|02|02|02
02|02|02|02|02|02|02|02|02|02|02|02|02|02|02|02|02|02|02|02|02|02|02|02|02|02|02|02|02|02|02|02|02|02|02|02|02|02|02|02
02|02|02|02|02|02|02|02|02|02|02|02|02|02|02|02|02|02|02|02|02|02|02|02|02|02|02|02|02|02|02|02|02|02|02|02|02|02|02|02
02|02|02|02|02|02|02|02|02|02|02|02|02|02|02|02|02|02|02|02|02|02|02|02|02|02|02|02|02|02|02|02|02|02|02|02|02|02|02|02
02|02|02|02|02|02|02|02|02|02|02|02|02|02|02|02|02|02|02|02|02|02|02|02|02|02|02|02|02|02|02|02|02|02|02|02|02|02|02|02
02|02|02|02|02|02|02|02|02|02|02|02|02|02|02|02|02|02|02|02|02|02|02|02|02|02|02|02|02|02|02|02|02|02|02|02|02|02|02|02
02|02|02|02|02|02|02|02|02|02|02|02|02|02|02|02|02|02|02|02|02|02|02|02|02|02|02|02|02|02|02|02|02|02|02|02|02|02|02|02
02|02|02|02|02|02|02|02|02|02|02|02|02|02|02|02|02|02|02|02|02|02|02|02|02|02|02|02|02|02|02|02|02|02|02|02|02|02|02|02
02|02|02|02|02|02|02|02|02|02|02|02|02|02|02|02|02|02|02|02|02|02|02|02|02|02|02|02|02|02|02|02|02|02|02|02|02|02|02|02
02|02|02|02|02|02|02|02|02|02|02|02|02|02|02|02|02|02|02|02|02|02|02|02|02|02|02|02|02|02|02|02|02|02|02|02|02|02|02|02
02|02|02|02|02|02|02|02|02|02|02|02|02|02|02|02|02|02|02|02|02|02|02|02|02|02|02|02|02|02|02|02|02|02|02|02|02|02|02|02
02|02|02|02|02|02|02|02|02|02|02|02|02|02|02|02|02|02|02|02|02|02|02|02|02|02|02|02|02|02|02|02|02|02|02|02|02|02|02|02
02|02|02|02|02|02|02|02|02|02|02|02|02|02|02|02|02|02|02|02|02|02|02|02|02|02|02|02|02|02|02|02|02|02|02|02|02|02|02|02
02|02|02|02|02|02|02|02|02|02|02|02|02|02|02|02|02|02|02|02|02|02|02|02|02|02|02|02|02|02|02|02|02|02|02|02|02|02|02|02
02|02|02|02|02|02|02|02|02|02|02|02|02|02|02|02|02|02|02|02|02|02|02|02|02|02|02|02|02|02|02|02|02|02|02|02|02|02|02|02
02|02|02|02|02|02|02|02|02|02|02|02|02|02|02|02|02|02|02|02|02|02|02|02|02|02|02|02|02|02|02|02|02|02|02|02|02|02|02|02
02|02|02|02|02|02|02|02|02|02|02|02|02|02|02|02|02|02|02|02|02|02|02|02|02|02|02|02|02|02|02|02|02|02|02|02|02|02|02|02
02|02|02|02|02|02|02|02|02|02|02|02|02|02|02|02|02|02|02|02|02|02|02|02|02|02|02|02|02|02|02|02|02|02|02|02|02|02|02|02
02|02|02|02|02|02|02|02|02|02|02|02|02|02|02|02|02|02|02|02|02|02|02|02|02|02|02|02|02|02|02|02|02|02|02|02|02|02|02|02
02|02|02|02|02|02|02|02|02|02|02|02|02|02|02|02|02|02|02|02|02|02|02|02|02|02|02|02|02|02|02|02|02|02|02|02|02|02|02|02
02|02|02|02|02|02|02|02|02|02|02|02|02|02|02|02|02|02|02|02|02|02|02|02|02|02|02|02|02|02|02|02|02|02|02|02|02|02|02|02
02|02|02|02|02|02|02|02|02|02|02|02|02|02|02|02|02|02|02|02|02|02|02|02|02|02|02|02|02|02|02|02|02|02|02|02|02|02|02|02
02|02|02|02|02|02|02|02|02|02|02|02|02|02|02|02|02|02|02|02|02|02|02|02|02|02|02|02|02|02|02|02|02|02|02|02|02|02|02|02
02|02|02|02|02|02|02|02|02|02|02|02|02|02|02|02|02|02|02|02|02|02|02|02|02|02|02|02|02|02|02|02|02|02|02|02|02|02|02|02
02|02|02|02|02|02|02|02|02|02|02|02|02|02|02|02|02|02|02|02|02|02|02|02|02|02|02|02|02|02|02|02|02|02|02|02|02|02|02|02
02|02|02|02|02|02|02|02|02|02|02|02|02|02|02|02|02|02|02|02|02|02|02|02|02|02|02|02|02|02|02|02|02|02|02|02|02|02|02|02
02|02|02|02|02|02|02|02|02|02|02|02|02|02|02|02|02|02|02|02|02|02|02|02|02|02|02|02|02|02|02|02|02|02|02|02|02|02|02|02
02|02|02|02|02|02|02|02|02|02|02|02|02|02|02|02|02|02|02|02|02|02|02|02|02|02|02|02|02|02|02|02|02|02|02|02|02|02|02|02
02|02|02|02|02|02|02|02|02|02|02|02|02|02|02|02|02|02|02|02|02|02|02|02|02|02|02|02|02|02|02|02|02|02|02|02|02|02|02|02
02|02|02|02|02|02|02|02|02|02|02|02|02|02|02|02|02|02|02|02|02|02|02|02|02|02|02|02|02|02|02|02|02|02|02|02|02|02|02|02
02|02|02|02|02|02|02|02|02|02|02|02|02|02|02|02|02|02|02|02|02|02|02|02|02|02|02|02|02|02|02|02|02|02|02|02|02|02|02|02
02|02|02|02|02|02|02|02|02|02|02|02|02|02|02|02|02|02|02|02|02|02|02|02|02|02|02|02|02|02|02|02|02|02|02|02|02|02|02|02
02|02|02|02|02|02|02|02|02|02|02|02|02|02|02|02|02|02|02|02|02|02|02|02|02|02|02|02|02|02|02|02|02|02|02|02|02|02|02|02
02|02|02|02|02|02|02|02|02|02|02|02|02|02|02|02|02|02|02|02|02|02|02|02|02|02|02|02|02|02|02|02|02|02|02|02|02|02|02|02
02|02|02|02|02|02|02|02|02|02|02|02|02|02|02|02|02|02|02|02|02|02|02|02|02|02|02|02|02|02|02|02|02|02|02|02|02|02|02|02
02|02|02|02|02|02|02|02|02|02|02|02|02|02|02|02|02|02|02|02|02|02|02|02|02|02|02|02|02|02|02|02|02|02|02|02|02|02|02|02
02|02|02|02|02|02|02|02|02|02|02|02|02|02|02|02|02|02|02|02|02|02|02|02|02|02|02|02|02|02|02|02|02|02|02|02|02|02|02|02
02|02|02|02|02|02|02|02|02|02|02|02|02|02|02|02|02|02|02|02|02|02|02|02|02|02|02|02|02|02|02|02|02|02|02|02|02|02|02|02

[TileLayer]
05|-1|-1|-1|-1|-1|-1|-1|-1|-1|-1|-1|-1|-1|-1|-1|-1|-1|-1|-1|-1|-1|-1|-1|-1|-1|-1|-1|-1|-1|-1|-1|-1|-1|-1|-1|-1|-1|00|00
-1|-1|-1|-1|-1|-1|-1|-1|-1|-1|-1|-1|-1|-1|-1|-1|-1|-1|-1|-1|-1|-1|-1|-1|-1|-1|-1|-1|-1|-1|-1|-1|-1|-1|-1|-1|-1|-1|00|00
03|03|03|03|-1|-1|-1|-1|-1|-1|-1|-1|-1|-1|-1|-1|-1|-1|-1|-1|-1|-1|-1|-1|-1|-1|-1|-1|-1|-1|-1|-1|-1|-1|-1|-1|-1|-1|00|00
03|03|03|03|03|-1|-1|-1|-1|-1|-1|-1|-1|-1|-1|-1|-1|-1|-1|-1|-1|-1|-1|-1|-1|-1|-1|-1|-1|-1|-1|-1|-1|-1|-1|-1|-1|-1|00|00
03|03|03|03|03|03|-1|-1|-1|-1|-1|-1|-1|-1|-1|-1|-1|-1|-1|-1|-1|-1|-1|-1|-1|-1|-1|-1|-1|-1|-1|-1|-1|-1|-1|-1|-1|-1|00|00
03|03|03|03|03|03|03|03|03|03|03|03|03|03|03|03|03|03|03|03|03|03|03|03|03|03|03|03|03|03|03|03|03|-1|-1|-1|-1|-1|00|00
03|03|03|03|03|03|03|03|03|03|03|03|03|03|03|03|03|03|03|03|03|03|03|03|03|03|03|03|03|03|03|03|03|03|-1|-1|-1|-1|00|00
00|00|-1|-1|-1|-1|-1|-1|-1|-1|-1|-1|-1|-1|-1|-1|-1|-1|-1|-1|-1|-1|-1|-1|-1|-1|-1|-1|-1|-1|03|03|03|03|03|-1|-1|-1|00|00
00|00|-1|03|03|03|03|03|03|03|03|03|03|03|03|03|03|03|03|03|03|03|03|03|03|03|03|03|-1|-1|-1|03|03|03|03|03|-1|-1|00|00
00|00|-1|03|03|03|03|03|03|03|03|03|03|03|03|03|03|03|03|03|03|03|03|03|03|03|03|03|03|-1|-1|-1|03|03|03|03|03|-1|00|00
00|00|-1|03|03|03|-1|-1|-1|-1|-1|-1|-1|-1|-1|-1|-1|-1|-1|-1|-1|-1|-1|-1|-1|-1|-1|-1|-1|-1|-1|-1|-1|-1|-1|-1|-1|-1|00|00
00|00|-1|03|03|03|03|03|03|03|03|03|03|03|03|03|03|03|03|03|03|03|03|03|03|03|03|03|03|03|03|03|03|03|03|03|03|03|00|00
00|00|-1|03|03|03|03|03|03|03|03|03|03|03|03|03|03|03|03|03|03|03|03|03|03|03|03|03|03|03|03|03|03|03|03|03|03|03|00|00
00|00|-1|-1|-1|-1|-1|-1|-1|-1|-1|-1|-1|-1|-1|-1|-1|-1|-1|-1|-1|-1|-1|-1|-1|-1|-1|-1|-1|-1|-1|-1|-1|-1|-1|-1|-1|-1|00|00
00|00|03|03|03|03|03|03|03|03|03|03|03|-1|-1|-1|-1|-1|-1|-1|-1|-1|-1|-1|-1|-1|-1|-1|-1|-1|-1|-1|-1|-1|-1|-1|-1|-1|00|00
00|00|03|03|03|03|03|03|03|03|03|03|03|03|-1|-1|03|03|-1|-1|03|03|-1|03|03|-1|-1|03|03|-1|-1|03|03|-1|-1|03|03|-1|00|00
00|00|-1|-1|-1|-1|-1|-1|-1|-1|-1|-1|03|03|03|-1|-1|-1|-1|-1|-1|-1|-1|-1|-1|-1|-1|-1|-1|-1|-1|-1|-1|-1|-1|03|03|-1|00|00
00|00|-1|-1|-1|-1|-1|-1|-1|-1|-1|-1|-1|03|03|03|-1|-1|-1|-1|-1|-1|-1|-1|-1|-1|-1|-1|-1|-1|-1|-1|-1|-1|-1|03|03|-1|00|00
00|00|-1|03|03|03|03|03|03|03|-1|-1|-1|-1|03|03|03|-1|-1|-1|-1|-1|-1|-1|-1|-1|-1|-1|-1|-1|-1|-1|-1|-1|-1|03|03|-1|00|00
00|00|-1|03|03|03|03|03|03|03|03|-1|-1|-1|-1|03|03|03|-1|-1|-1|-1|-1|-1|-1|-1|-1|-1|-1|-1|-1|-1|-1|-1|-1|03|03|-1|00|00
00|00|-1|03|03|03|03|03|03|03|03|03|-1|-1|-1|-1|03|03|03|-1|-1|-1|-1|-1|-1|-1|-1|-1|-1|-1|-1|-1|-1|-1|-1|03|03|-1|00|00
00|00|-1|03|03|03|03|03|03|03|03|03|03|-1|-1|-1|-1|03|03|03|03|03|03|03|03|03|03|03|03|03|03|03|03|03|03|03|03|-1|00|00
00|00|-1|03|03|03|03|03|03|03|03|03|03|03|03|-1|-1|03|03|03|03|03|03|03|03|03|03|03|03|03|03|03|03|03|03|03|03|-1|00|00
00|00|-1|03|03|03|03|03|03|03|03|03|03|03|03|03|-1|-1|-1|-1|-1|-1|-1|-1|-1|-1|-1|-1|-1|-1|-1|-1|-1|-1|-1|-1|-1|-1|00|00
00|00|-1|03|03|03|03|03|03|03|03|03|03|03|03|03|03|03|03|03|03|03|03|03|03|-1|-1|-1|-1|-1|-1|-1|-1|-1|-1|-1|-1|-1|00|00
00|00|-1|03|03|03|03|03|03|03|03|03|03|03|03|03|03|03|03|03|03|03|03|03|03|03|03|03|03|03|03|03|03|03|03|03|03|03|00|00
00|00|-1|03|03|03|03|03|03|03|03|03|03|03|03|03|03|03|03|03|03|03|03|03|03|03|03|03|03|03|03|03|03|03|03|03|03|03|00|00
00|00|-1|03|03|-1|-1|-1|-1|-1|-1|-1|-1|-1|-1|-1|-1|-1|-1|-1|-1|-1|-1|-1|-1|-1|-1|-1|-1|-1|-1|-1|-1|-1|-1|-1|-1|-1|00|00
00|00|-1|03|03|-1|-1|-1|-1|-1|-1|-1|-1|-1|-1|-1|-1|-1|-1|-1|-1|-1|-1|-1|-1|-1|-1|-1|-1|-1|-1|-1|-1|-1|-1|-1|-1|-1|00|00
00|00|-1|03|03|-1|-1|-1|-1|-1|-1|-1|-1|-1|-1|03|-1|03|03|-1|-1|-1|-1|-1|-1|-1|-1|-1|-1|-1|-1|-1|-1|-1|-1|-1|-1|-1|00|00
00|00|-1|03|03|-1|-1|-1|-1|-1|-1|-1|-1|03|-1|03|-1|03|03|03|-1|-1|-1|-1|-1|-1|-1|-1|-1|-1|-1|-1|-1|-1|-1|-1|-1|-1|00|00
00|00|-1|03|03|-1|-1|-1|-1|-1|-1|03|-1|03|-1|03|-1|03|03|03|03|-1|-1|-1|-1|-1|-1|-1|-1|-1|-1|-1|-1|-1|-1|-1|-1|-1|00|00
00|00|-1|-1|-1|-1|-1|-1|-1|03|-1|03|-1|03|-1|03|-1|03|03|03|03|03|-1|-1|-1|-1|-1|-1|-1|-1|-1|-1|-1|-1|-1|-1|-1|-1|00|00
00|00|-1|-1|-1|-1|-1|03|-1|-1|-1|-1|-1|-1|-1|-1|-1|03|03|03|03|03|03|-1|-1|-1|-1|-1|-1|-1|-1|-1|-1|-1|-1|-1|-1|04|00|00
00|00|03|03|03|03|03|03|03|03|03|03|03|03|03|03|03|03|03|03|03|03|03|03|03|03|03|03|03|03|03|03|03|03|03|03|03|03|00|00
00|00|00|00|00|00|00|00|00|00|00|00|00|00|00|00|00|00|00|00|00|00|00|00|00|00|00|00|00|00|00|00|00|00|00|00|00|00|00|00
00|00|00|00|00|00|00|00|00|00|00|00|00|00|00|00|00|00|00|00|00|00|00|00|00|00|00|00|00|00|00|00|00|00|00|00|00|00|00|00
00|00|00|00|00|00|00|00|00|00|00|00|00|00|00|00|00|00|00|00|00|00|00|00|00|00|00|00|00|00|00|00|00|00|00|00|00|00|00|00
00|00|00|00|00|00|00|00|00|00|00|00|00|00|00|00|00|00|00|00|00|00|00|00|00|00|00|00|00|00|00|00|00|00|00|00|00|00|00|00
00|00|00|00|00|00|00|00|00|00|00|00|00|00|00|00|00|00|00|00|00|00|00|00|00|00|00|00|00|00|00|00|00|00|00|00|00|00|00|00

[CollisionLayer]
-1|-1|-1|-1|-1|-1|-1|-1|-1|-1|-1|-1|-1|-1|-1|-1|-1|-1|-1|-1|-1|-1|-1|-1|-1|-1|-1|-1|-1|-1|-1|-1|-1|-1|-1|-1|-1|-1|-2|-1
-3|-1|-1|-1|-1|-1|-1|-1|-1|-1|-1|-1|-1|-1|-1|-1|-1|-1|-1|-1|-1|-1|-1|-1|-1|-1|-1|-1|-1|-1|-1|-1|-1|-1|-1|-1|-1|-1|-2|-1
-2|-2|-2|-2|-1|-1|-1|-1|-1|-1|-1|-1|-1|-1|-1|-1|-1|-1|-1|-1|-1|-1|-1|-1|-1|-1|-1|-1|-1|-1|-1|-1|-1|-1|-1|-1|-1|-1|-2|-1
-1|-1|-1|-2|-2|-1|-1|-1|-1|-1|-1|-1|-1|-1|-1|-1|-1|-1|-1|-1|-1|-1|-1|-1|-1|-1|-1|-1|-1|-1|-1|-1|-1|-1|-1|-1|-1|-1|-2|-1
-1|-1|-1|-1|-2|-2|-1|-1|-1|-1|-1|-1|-1|-1|-1|-1|-1|-1|-1|-1|-1|-1|-1|-1|-1|-1|-1|-1|-1|-1|-1|-1|-1|-1|-1|-1|-1|-1|-2|-1
-1|-1|-1|-1|-1|-2|-2|-2|-2|-2|-2|-2|-2|-2|-2|-2|-2|-2|-2|-2|-2|-2|-2|-2|-2|-2|-2|-2|-2|-2|-2|-2|-2|-1|-1|-1|-1|-1|-2|-1
-1|-2|-2|-2|-2|-2|-2|-2|-2|-2|-2|-2|-2|-2|-2|-2|-2|-2|-2|-2|-2|-2|-2|-2|-2|-2|-2|-2|-2|-2|-2|-2|-2|-2|-1|-1|-1|-1|-2|-1
-1|-2|-1|-1|-1|-1|-1|-1|-1|-1|-1|-1|-1|-1|-1|-1|-1|-1|-1|-1|-1|-1|-1|-1|-1|-1|-1|-1|-1|-1|-2|-2|-2|-2|-2|-1|-1|-1|-2|-1
-1|-2|-1|-2|-2|-2|-2|-2|-2|-2|-2|-2|-2|-2|-2|-2|-2|-2|-2|-2|-2|-2|-2|-2|-2|-2|-2|-2|-1|-1|-1|-2|-2|-2|-2|-2|-1|-1|-2|-1
-1|-2|-1|-2|-2|-2|-2|-2|-2|-2|-2|-2|-2|-2|-2|-2|-2|-2|-2|-2|-2|-2|-2|-2|-2|-2|-2|-2|-2|-1|-1|-1|-2|-2|-2|-2|-2|-1|-2|-1
-1|-2|-1|-2|-2|-2|-1|-1|-1|-1|-1|-1|-1|-1|-1|-1|-1|-1|-1|-1|-1|-1|-1|-1|-1|-1|-1|-1|-1|-1|-1|-1|-1|-1|-1|-1|-1|-1|-2|-1
-1|-2|-1|-2|-2|-2|-2|-2|-2|-2|-2|-2|-2|-2|-2|-2|-2|-2|-2|-2|-2|-2|-2|-2|-2|-2|-2|-2|-2|-2|-2|-2|-2|-2|-2|-2|-2|-2|-2|-1
-1|-2|-1|-2|-2|-2|-2|-2|-2|-2|-2|-2|-2|-2|-2|-2|-2|-2|-2|-2|-2|-2|-2|-2|-2|-2|-2|-2|-2|-2|-2|-2|-2|-2|-2|-2|-2|-2|-2|-1
-1|-2|-1|-1|-1|-1|-1|-1|-1|-1|-1|-1|-1|-1|-1|-1|-1|-1|-1|-1|-1|-1|-1|-1|-1|-1|-1|-1|-1|-1|-1|-1|-1|-1|-1|-1|-1|-1|-2|-1
-1|-2|-2|-2|-2|-2|-2|-2|-2|-2|-2|-2|-2|-1|-1|-1|-1|-1|-1|-1|-1|-1|-1|-1|-1|-1|-1|-1|-1|-1|-1|-1|-1|-1|-1|-1|-1|-1|-2|-1
-1|-2|-2|-2|-2|-2|-2|-2|-2|-2|-2|-2|-2|-2|-1|-1|-2|-2|-1|-1|-2|-2|-1|-2|-2|-1|-1|-2|-2|-1|-1|-2|-2|-1|-1|-2|-2|-1|-2|-1
-1|-2|-1|-1|-1|-1|-1|-1|-1|-1|-1|-1|-2|-2|-2|-1|-1|-1|-1|-1|-1|-1|-1|-1|-1|-1|-1|-1|-1|-1|-1|-1|-1|-1|-1|-2|-2|-1|-2|-1
-1|-2|-1|-1|-1|-1|-1|-1|-1|-1|-1|-1|-1|-2|-2|-2|-1|-1|-1|-1|-1|-1|-1|-1|-1|-1|-1|-1|-1|-1|-1|-1|-1|-1|-1|-2|-2|-1|-2|-1
-1|-2|-1|-2|-2|-2|-2|-2|-2|-2|-1|-1|-1|-1|-2|-2|-2|-1|-1|-1|-1|-1|-1|-1|-1|-1|-1|-1|-1|-1|-1|-1|-1|-1|-1|-2|-2|-1|-2|-1
-1|-2|-1|-2|-1|-1|-1|-1|-1|-2|-2|-1|-1|-1|-1|-2|-2|-2|-1|-1|-1|-1|-1|-1|-1|-1|-1|-1|-1|-1|-1|-1|-1|-1|-1|-2|-2|-1|-2|-1
-1|-2|-1|-2|-1|-1|-1|-1|-1|-1|-2|-2|-1|-1|-1|-1|-2|-2|-2|-1|-1|-1|-1|-1|-1|-1|-1|-1|-1|-1|-1|-1|-1|-1|-1|-2|-2|-1|-2|-1
-1|-2|-1|-2|-1|-1|-1|-1|-1|-1|-1|-2|-2|-1|-1|-1|-1|-2|-2|-2|-2|-2|-2|-2|-2|-2|-2|-2|-2|-2|-2|-2|-2|-2|-2|-2|-2|-1|-2|-1
-1|-2|-1|-2|-1|-1|-1|-1|-1|-1|-1|-1|-2|-2|-2|-1|-1|-2|-2|-2|-2|-2|-2|-2|-2|-2|-2|-2|-2|-2|-2|-2|-2|-2|-2|-2|-2|-1|-2|-1
-1|-2|-1|-2|-1|-1|-1|-1|-1|-1|-1|-1|-1|-1|-2|-2|-1|-1|-1|-1|-1|-1|-1|-1|-1|-1|-1|-1|-1|-1|-1|-1|-1|-1|-1|-1|-1|-1|-2|-1
-1|-2|-1|-2|-1|-1|-1|-1|-1|-1|-1|-1|-1|-1|-1|-2|-2|-2|-2|-2|-2|-2|-2|-2|-2|-1|-1|-1|-1|-1|-1|-1|-1|-1|-1|-1|-1|-1|-2|-1
-1|-2|-1|-2|-1|-1|-1|-1|-1|-1|-1|-1|-1|-1|-1|-1|-1|-1|-1|-1|-1|-1|-1|-1|-2|-2|-2|-2|-2|-2|-2|-2|-2|-2|-2|-2|-2|-2|-2|-1
-1|-2|-1|-2|-2|-2|-2|-2|-2|-2|-2|-2|-2|-2|-2|-2|-2|-2|-2|-2|-2|-2|-2|-2|-2|-2|-2|-2|-2|-2|-2|-2|-2|-2|-2|-2|-2|-2|-2|-1
-1|-2|-1|-2|-2|-1|-1|-1|-1|-1|-1|-1|-1|-1|-1|-1|-1|-1|-1|-1|-1|-1|-1|-1|-1|-1|-1|-1|-1|-1|-1|-1|-1|-1|-1|-1|-1|-1|-2|-1
-1|-2|-1|-2|-2|-1|-1|-1|-1|-1|-1|-1|-1|-1|-1|-1|-1|-1|-1|-1|-1|-1|-1|-1|-1|-1|-1|-1|-1|-1|-1|-1|-1|-1|-1|-1|-1|-1|-2|-1
-1|-2|-1|-2|-2|-1|-1|-1|-1|-1|-1|-1|-1|-1|-1|-2|-1|-2|-2|-1|-1|-1|-1|-1|-1|-1|-1|-1|-1|-1|-1|-1|-1|-1|-1|-1|-1|-1|-2|-1
-1|-2|-1|-2|-2|-1|-1|-1|-1|-1|-1|-1|-1|-2|-1|-2|-1|-2|-2|-2|-1|-1|-1|-1|-1|-1|-1|-1|-1|-1|-1|-1|-1|-1|-1|-1|-1|-1|-2|-1
-1|-2|-1|-2|-2|-1|-1|-1|-1|-1|-1|-2|-1|-2|-1|-2|-1|-2|-1|-2|-2|-1|-1|-1|-1|-1|-1|-1|-1|-1|-1|-1|-1|-1|-1|-1|-1|-1|-2|-1
-1|-2|-1|-1|-1|-1|-1|-1|-1|-2|-1|-2|-1|-2|-1|-2|-1|-2|-1|-1|-2|-2|-1|-1|-1|-1|-1|-1|-1|-1|-1|-1|-1|-1|-1|-1|-1|-1|-2|-1
-1|-2|-1|-1|-1|-1|-1|-2|-1|-1|-1|-1|-1|-1|-1|-1|-1|-2|-1|-1|-1|-2|-2|-1|-1|-1|-1|-1|-1|-1|-1|-1|-1|-1|-1|-1|-1|00|-2|-1
-1|-2|-2|-2|-2|-2|-2|-2|-2|-2|-2|-2|-2|-2|-2|-2|-2|-2|-1|-1|-1|-1|-2|-2|-2|-2|-2|-2|-2|-2|-2|-2|-2|-2|-2|-2|-2|-2|-2|-1
-1|-1|-1|-1|-1|-1|-1|-1|-1|-1|-1|-1|-1|-1|-1|-1|-1|-1|-1|-1|-1|-1|-1|-1|-1|-1|-1|-1|-1|-1|-1|-1|-1|-1|-1|-1|-1|-1|-1|-1
-1|-1|-1|-1|-1|-1|-1|-1|-1|-1|-1|-1|-1|-1|-1|-1|-1|-1|-1|-1|-1|-1|-1|-1|-1|-1|-1|-1|-1|-1|-1|-1|-1|-1|-1|-1|-1|-1|-1|-1
-1|-1|-1|-1|-1|-1|-1|-1|-1|-1|-1|-1|-1|-1|-1|-1|-1|-1|-1|-1|-1|-1|-1|-1|-1|-1|-1|-1|-1|-1|-1|-1|-1|-1|-1|-1|-1|-1|-1|-1
-1|-1|-1|-1|-1|-1|-1|-1|-1|-1|-1|-1|-1|-1|-1|-1|-1|-1|-1|-1|-1|-1|-1|-1|-1|-1|-1|-1|-1|-1|-1|-1|-1|-1|-1|-1|-1|-1|-1|-1
-1|-1|-1|-1|-1|-1|-1|-1|-1|-1|-1|-1|-1|-1|-1|-1|-1|-1|-1|-1|-1|-1|-1|-1|-1|-1|-1|-1|-1|-1|-1|-1|-1|-1|-1|-1|-1|-1|-1|-1
