[Demensions]
7x7

[TileDemensions]
64x64

[Textures]
Inside\Floors\Wood 64 64
Inside\Floors\Tile_Grey 64 64

[TileLayer]
00|00|00|00|00|00|00
00|00|01|01|01|00|00
00|00|01|01|01|00|00
00|00|00|01|00|00|00
00|00|00|01|00|00|00
00|00|00|01|00|00|00
00|00|00|01|00|00|00

[CollisionLayer]
00|00|00|00|00|00|00
00|00|00|00|00|00|00
00|00|00|00|00|00|00
00|00|00|00|00|00|00
00|00|00|00|00|00|00
00|00|00|00|00|00|00
00|00|00|00|00|00|00
