[Demensions]
7x7

[TileDemensions]
64x64

[Textures]
Background\Grass 64 64
Background\Dirt 64 64
Inside\Floors\Tile_Grey 64 64
Sprites\NPI\Sprites\NPC_TheOracle_Trapped 64 64
Background\Tree1 64 64
Background\Tree2 64 64
Background\Tree3 64 64

[TileLayer]
00|00|00|00|00|00|00
00|00|00|02|00|00|00
00|00|00|02|00|00|00
00|00|00|02|00|00|00
00|00|00|02|00|00|00
00|00|00|02|00|00|00
00|00|00|02|00|00|00

[TileLayer]
05|04|06|05|04|05|04
04|06|04|03|05|06|04
06|05|05|-1|04|04|05
05|04|-1|-1|-1|05|04
04|06|-1|-1|-1|06|04
06|05|-1|-1|-1|04|05
04|06|-1|-1|-1|06|06

[CollisionLayer]
00|00|-1|-1|-1|00|00
00|00|-1|00|-1|00|00
00|-1|-1|00|-1|-1|00
00|-1|00|00|00|-1|00
00|-1|00|00|00|-1|00
00|-1|00|00|00|-1|00
00|-1|00|00|00|-1|00
