[Type]
Dungeon

[Demensions]
50x50

[TileDemensions]
64x64

[Textures]
Dungeon\Tree\D3Background 3200 3200
Dungeon\Tree\Bark3 64 64
Dungeon\Tree\Bark2 64 64
Dungeon\Tree\Bark1 64 64
Dungeon\Fin 64 64
Dungeon\Start 64 64
Inside\Floors\Wood 64 64

[Entrances]
collisionBlock
TileMaps\D3End.map

[TileLayer]
00|-1|-1|-1|-1|-1|-1|-1|-1|-1|-1|-1|-1|-1|-1|-1|-1|-1|-1|-1|-1|-1|-1|-1|-1|-1|-1|-1|-1|-1|-1|-1|-1|-1|-1|-1|-1|-1|-1|-1|-1|-1|-1|-1|-1|-1|-1|-1|-1|-1
-1|-1|-1|-1|-1|-1|-1|-1|-1|-1|-1|-1|-1|-1|-1|-1|-1|-1|-1|-1|-1|-1|-1|-1|-1|-1|-1|-1|-1|-1|-1|-1|-1|-1|-1|-1|-1|-1|-1|-1|-1|-1|-1|-1|-1|-1|-1|-1|-1|-1
-1|-1|-1|-1|-1|-1|-1|-1|-1|-1|-1|-1|-1|-1|-1|-1|-1|-1|-1|-1|-1|-1|-1|-1|-1|-1|-1|-1|-1|-1|-1|-1|-1|-1|-1|-1|-1|-1|-1|-1|-1|-1|-1|-1|-1|-1|-1|-1|-1|-1
-1|-1|-1|-1|-1|-1|-1|-1|-1|-1|-1|-1|-1|-1|-1|-1|-1|-1|-1|-1|-1|-1|-1|-1|-1|-1|-1|-1|-1|-1|-1|-1|-1|-1|-1|-1|-1|-1|-1|-1|-1|-1|-1|-1|-1|-1|-1|-1|-1|-1
-1|-1|-1|-1|-1|-1|-1|-1|-1|-1|-1|-1|-1|-1|-1|-1|-1|-1|-1|-1|-1|-1|-1|-1|-1|-1|-1|-1|-1|-1|-1|-1|-1|-1|-1|-1|-1|-1|-1|-1|-1|-1|-1|-1|-1|-1|-1|-1|-1|-1
-1|-1|-1|-1|-1|-1|-1|-1|-1|-1|-1|-1|-1|-1|-1|-1|-1|-1|-1|-1|-1|-1|-1|-1|-1|-1|-1|-1|-1|-1|-1|-1|-1|-1|-1|-1|-1|-1|-1|-1|-1|-1|-1|-1|-1|-1|-1|-1|-1|-1
-1|-1|-1|-1|-1|-1|-1|-1|-1|-1|-1|-1|-1|-1|-1|-1|-1|-1|-1|-1|-1|-1|-1|-1|-1|-1|-1|-1|-1|-1|-1|-1|-1|-1|-1|-1|-1|-1|-1|-1|-1|-1|-1|-1|-1|-1|-1|-1|-1|-1
-1|-1|-1|-1|-1|-1|-1|-1|-1|-1|-1|-1|-1|-1|-1|-1|-1|-1|-1|-1|-1|-1|-1|-1|-1|-1|-1|-1|-1|-1|-1|-1|-1|-1|-1|-1|-1|-1|-1|-1|-1|-1|-1|-1|-1|-1|-1|-1|-1|-1
-1|-1|-1|-1|-1|-1|-1|-1|-1|-1|-1|-1|-1|-1|-1|-1|-1|-1|-1|-1|-1|-1|-1|-1|-1|-1|-1|-1|-1|-1|-1|-1|-1|-1|-1|-1|-1|-1|-1|-1|-1|-1|-1|-1|-1|-1|-1|-1|-1|-1
-1|-1|-1|-1|-1|-1|-1|-1|-1|-1|-1|-1|-1|-1|-1|-1|-1|-1|-1|-1|-1|-1|-1|-1|-1|-1|-1|-1|-1|-1|-1|-1|-1|-1|-1|-1|-1|-1|-1|-1|-1|-1|-1|-1|-1|-1|-1|-1|-1|-1
-1|-1|-1|-1|-1|-1|-1|-1|-1|-1|-1|-1|-1|-1|-1|-1|-1|-1|-1|-1|-1|-1|-1|-1|-1|-1|-1|-1|-1|-1|-1|-1|-1|-1|-1|-1|-1|-1|-1|-1|-1|-1|-1|-1|-1|-1|-1|-1|-1|-1
-1|-1|-1|-1|-1|-1|-1|-1|-1|-1|-1|-1|-1|-1|-1|-1|-1|-1|-1|-1|-1|-1|-1|-1|-1|-1|-1|-1|-1|-1|-1|-1|-1|-1|-1|-1|-1|-1|-1|-1|-1|-1|-1|-1|-1|-1|-1|-1|-1|-1
-1|-1|-1|-1|-1|-1|-1|-1|-1|-1|-1|-1|-1|-1|-1|-1|-1|-1|-1|-1|-1|-1|-1|-1|-1|-1|-1|-1|-1|-1|-1|-1|-1|-1|-1|-1|-1|-1|-1|-1|-1|-1|-1|-1|-1|-1|-1|-1|-1|-1
-1|-1|-1|-1|-1|-1|-1|-1|-1|-1|-1|-1|-1|-1|-1|-1|-1|-1|-1|-1|-1|-1|-1|-1|-1|-1|-1|-1|-1|-1|-1|-1|-1|-1|-1|-1|-1|-1|-1|-1|-1|-1|-1|-1|-1|-1|-1|-1|-1|-1
-1|-1|-1|-1|-1|-1|-1|-1|-1|-1|-1|-1|-1|-1|-1|-1|-1|-1|-1|-1|-1|-1|-1|-1|-1|-1|-1|-1|-1|-1|-1|-1|-1|-1|-1|-1|-1|-1|-1|-1|-1|-1|-1|-1|-1|-1|-1|-1|-1|-1
-1|-1|-1|-1|-1|-1|-1|-1|-1|-1|-1|-1|-1|-1|-1|-1|-1|-1|-1|-1|-1|-1|-1|-1|-1|-1|-1|-1|-1|-1|-1|-1|-1|-1|-1|-1|-1|-1|-1|-1|-1|-1|-1|-1|-1|-1|-1|-1|-1|-1
-1|-1|-1|-1|-1|-1|-1|-1|-1|-1|-1|-1|-1|-1|-1|-1|-1|-1|-1|-1|-1|-1|-1|-1|-1|-1|-1|-1|-1|-1|-1|-1|-1|-1|-1|-1|-1|-1|-1|-1|-1|-1|-1|-1|-1|-1|-1|-1|-1|-1
-1|-1|-1|-1|-1|-1|-1|-1|-1|-1|-1|-1|-1|-1|-1|-1|-1|-1|-1|-1|-1|-1|-1|-1|-1|-1|-1|-1|-1|-1|-1|-1|-1|-1|-1|-1|-1|-1|-1|-1|-1|-1|-1|-1|-1|-1|-1|-1|-1|-1
-1|-1|-1|-1|-1|-1|-1|-1|-1|-1|-1|-1|-1|-1|-1|-1|-1|-1|-1|-1|-1|-1|-1|-1|-1|-1|-1|-1|-1|-1|-1|-1|-1|-1|-1|-1|-1|-1|-1|-1|-1|-1|-1|-1|-1|-1|-1|-1|-1|-1
-1|-1|-1|-1|-1|-1|-1|-1|-1|-1|-1|-1|-1|-1|-1|-1|-1|-1|-1|-1|-1|-1|-1|-1|-1|-1|-1|-1|-1|-1|-1|-1|-1|-1|-1|-1|-1|-1|-1|-1|-1|-1|-1|-1|-1|-1|-1|-1|-1|-1
-1|-1|-1|-1|-1|-1|-1|-1|-1|-1|-1|-1|-1|-1|-1|-1|-1|-1|-1|-1|-1|-1|-1|-1|-1|-1|-1|-1|-1|-1|-1|-1|-1|-1|-1|-1|-1|-1|-1|-1|-1|-1|-1|-1|-1|-1|-1|-1|-1|-1
-1|-1|-1|-1|-1|-1|-1|-1|-1|-1|-1|-1|-1|-1|-1|-1|-1|-1|-1|-1|-1|-1|-1|-1|-1|-1|-1|-1|-1|-1|-1|-1|-1|-1|-1|-1|-1|-1|-1|-1|-1|-1|-1|-1|-1|-1|-1|-1|-1|-1
-1|-1|-1|-1|-1|-1|-1|-1|-1|-1|-1|-1|-1|-1|-1|-1|-1|-1|-1|-1|-1|-1|-1|-1|-1|-1|-1|-1|-1|-1|-1|-1|-1|-1|-1|-1|-1|-1|-1|-1|-1|-1|-1|-1|-1|-1|-1|-1|-1|-1
-1|-1|-1|-1|-1|-1|-1|-1|-1|-1|-1|-1|-1|-1|-1|-1|-1|-1|-1|-1|-1|-1|-1|-1|-1|-1|-1|-1|-1|-1|-1|-1|-1|-1|-1|-1|-1|-1|-1|-1|-1|-1|-1|-1|-1|-1|-1|-1|-1|-1
-1|-1|-1|-1|-1|-1|-1|-1|-1|-1|-1|-1|-1|-1|-1|-1|-1|-1|-1|-1|-1|-1|-1|-1|-1|-1|-1|-1|-1|-1|-1|-1|-1|-1|-1|-1|-1|-1|-1|-1|-1|-1|-1|-1|-1|-1|-1|-1|-1|-1
-1|-1|-1|-1|-1|-1|-1|-1|-1|-1|-1|-1|-1|-1|-1|-1|-1|-1|-1|-1|-1|-1|-1|-1|-1|-1|-1|-1|-1|-1|-1|-1|-1|-1|-1|-1|-1|-1|-1|-1|-1|-1|-1|-1|-1|-1|-1|-1|-1|-1
-1|-1|-1|-1|-1|-1|-1|-1|-1|-1|-1|-1|-1|-1|-1|-1|-1|-1|-1|-1|-1|-1|-1|-1|-1|-1|-1|-1|-1|-1|-1|-1|-1|-1|-1|-1|-1|-1|-1|-1|-1|-1|-1|-1|-1|-1|-1|-1|-1|-1
-1|-1|-1|-1|-1|-1|-1|-1|-1|-1|-1|-1|-1|-1|-1|-1|-1|-1|-1|-1|-1|-1|-1|-1|-1|-1|-1|-1|-1|-1|-1|-1|-1|-1|-1|-1|-1|-1|-1|-1|-1|-1|-1|-1|-1|-1|-1|-1|-1|-1
-1|-1|-1|-1|-1|-1|-1|-1|-1|-1|-1|-1|-1|-1|-1|-1|-1|-1|-1|-1|-1|-1|-1|-1|-1|-1|-1|-1|-1|-1|-1|-1|-1|-1|-1|-1|-1|-1|-1|-1|-1|-1|-1|-1|-1|-1|-1|-1|-1|-1
-1|-1|-1|-1|-1|-1|-1|-1|-1|-1|-1|-1|-1|-1|-1|-1|-1|-1|-1|-1|-1|-1|-1|-1|-1|-1|-1|-1|-1|-1|-1|-1|-1|-1|-1|-1|-1|-1|-1|-1|-1|-1|-1|-1|-1|-1|-1|-1|-1|-1
-1|-1|-1|-1|-1|-1|-1|-1|-1|-1|-1|-1|-1|-1|-1|-1|-1|-1|-1|-1|-1|-1|-1|-1|-1|-1|-1|-1|-1|-1|-1|-1|-1|-1|-1|-1|-1|-1|-1|-1|-1|-1|-1|-1|-1|-1|-1|-1|-1|-1
-1|-1|-1|-1|-1|-1|-1|-1|-1|-1|-1|-1|-1|-1|-1|-1|-1|-1|-1|-1|-1|-1|-1|-1|-1|-1|-1|-1|-1|-1|-1|-1|-1|-1|-1|-1|-1|-1|-1|-1|-1|-1|-1|-1|-1|-1|-1|-1|-1|-1
-1|-1|-1|-1|-1|-1|-1|-1|-1|-1|-1|-1|-1|-1|-1|-1|-1|-1|-1|-1|-1|-1|-1|-1|-1|-1|-1|-1|-1|-1|-1|-1|-1|-1|-1|-1|-1|-1|-1|-1|-1|-1|-1|-1|-1|-1|-1|-1|-1|-1
-1|-1|-1|-1|-1|-1|-1|-1|-1|-1|-1|-1|-1|-1|-1|-1|-1|-1|-1|-1|-1|-1|-1|-1|-1|-1|-1|-1|-1|-1|-1|-1|-1|-1|-1|-1|-1|-1|-1|-1|-1|-1|-1|-1|-1|-1|-1|-1|-1|-1
-1|-1|-1|-1|-1|-1|-1|-1|-1|-1|-1|-1|-1|-1|-1|-1|-1|-1|-1|-1|-1|-1|-1|-1|-1|-1|-1|-1|-1|-1|-1|-1|-1|-1|-1|-1|-1|-1|-1|-1|-1|-1|-1|-1|-1|-1|-1|-1|-1|-1
-1|-1|-1|-1|-1|-1|-1|-1|-1|-1|-1|-1|-1|-1|-1|-1|-1|-1|-1|-1|-1|-1|-1|-1|-1|-1|-1|-1|-1|-1|-1|-1|-1|-1|-1|-1|-1|-1|-1|-1|-1|-1|-1|-1|-1|-1|-1|-1|-1|-1
-1|-1|-1|-1|-1|-1|-1|-1|-1|-1|-1|-1|-1|-1|-1|-1|-1|-1|-1|-1|-1|-1|-1|-1|-1|-1|-1|-1|-1|-1|-1|-1|-1|-1|-1|-1|-1|-1|-1|-1|-1|-1|-1|-1|-1|-1|-1|-1|-1|-1
-1|-1|-1|-1|-1|-1|-1|-1|-1|-1|-1|-1|-1|-1|-1|-1|-1|-1|-1|-1|-1|-1|-1|-1|-1|-1|-1|-1|-1|-1|-1|-1|-1|-1|-1|-1|-1|-1|-1|-1|-1|-1|-1|-1|-1|-1|-1|-1|-1|-1
-1|-1|-1|-1|-1|-1|-1|-1|-1|-1|-1|-1|-1|-1|-1|-1|-1|-1|-1|-1|-1|-1|-1|-1|-1|-1|-1|-1|-1|-1|-1|-1|-1|-1|-1|-1|-1|-1|-1|-1|-1|-1|-1|-1|-1|-1|-1|-1|-1|-1
-1|-1|-1|-1|-1|-1|-1|-1|-1|-1|-1|-1|-1|-1|-1|-1|-1|-1|-1|-1|-1|-1|-1|-1|-1|-1|-1|-1|-1|-1|-1|-1|-1|-1|-1|-1|-1|-1|-1|-1|-1|-1|-1|-1|-1|-1|-1|-1|-1|-1
-1|-1|-1|-1|-1|-1|-1|-1|-1|-1|-1|-1|-1|-1|-1|-1|-1|-1|-1|-1|-1|-1|-1|-1|-1|-1|-1|-1|-1|-1|-1|-1|-1|-1|-1|-1|-1|-1|-1|-1|-1|-1|-1|-1|-1|-1|-1|-1|-1|-1
-1|-1|-1|-1|-1|-1|-1|-1|-1|-1|-1|-1|-1|-1|-1|-1|-1|-1|-1|-1|-1|-1|-1|-1|-1|-1|-1|-1|-1|-1|-1|-1|-1|-1|-1|-1|-1|-1|-1|-1|-1|-1|-1|-1|-1|-1|-1|-1|-1|-1
-1|-1|-1|-1|-1|-1|-1|-1|-1|-1|-1|-1|-1|-1|-1|-1|-1|-1|-1|-1|-1|-1|-1|-1|-1|-1|-1|-1|-1|-1|-1|-1|-1|-1|-1|-1|-1|-1|-1|-1|-1|-1|-1|-1|-1|-1|-1|-1|-1|-1
-1|-1|-1|-1|-1|-1|-1|-1|-1|-1|-1|-1|-1|-1|-1|-1|-1|-1|-1|-1|-1|-1|-1|-1|-1|-1|-1|-1|-1|-1|-1|-1|-1|-1|-1|-1|-1|-1|-1|-1|-1|-1|-1|-1|-1|-1|-1|-1|-1|-1
-1|-1|-1|-1|-1|-1|-1|-1|-1|-1|-1|-1|-1|-1|-1|-1|-1|-1|-1|-1|-1|-1|-1|-1|-1|-1|-1|-1|-1|-1|-1|-1|-1|-1|-1|-1|-1|-1|-1|-1|-1|-1|-1|-1|-1|-1|-1|-1|-1|-1
-1|-1|-1|-1|-1|-1|-1|-1|-1|-1|-1|-1|-1|-1|-1|-1|-1|-1|-1|-1|-1|-1|-1|-1|-1|-1|-1|-1|-1|-1|-1|-1|-1|-1|-1|-1|-1|-1|-1|-1|-1|-1|-1|-1|-1|-1|-1|-1|-1|-1
-1|-1|-1|-1|-1|-1|-1|-1|-1|-1|-1|-1|-1|-1|-1|-1|-1|-1|-1|-1|-1|-1|-1|-1|-1|-1|-1|-1|-1|-1|-1|-1|-1|-1|-1|-1|-1|-1|-1|-1|-1|-1|-1|-1|-1|-1|-1|-1|-1|-1
-1|-1|-1|-1|-1|-1|-1|-1|-1|-1|-1|-1|-1|-1|-1|-1|-1|-1|-1|-1|-1|-1|-1|-1|-1|-1|-1|-1|-1|-1|-1|-1|-1|-1|-1|-1|-1|-1|-1|-1|-1|-1|-1|-1|-1|-1|-1|-1|-1|-1
-1|-1|-1|-1|-1|-1|-1|-1|-1|-1|-1|-1|-1|-1|-1|-1|-1|-1|-1|-1|-1|-1|-1|-1|-1|-1|-1|-1|-1|-1|-1|-1|-1|-1|-1|-1|-1|-1|-1|-1|-1|-1|-1|-1|-1|-1|-1|-1|-1|-1
-1|-1|-1|-1|-1|-1|-1|-1|-1|-1|-1|-1|-1|-1|-1|-1|-1|-1|-1|-1|-1|-1|-1|-1|-1|-1|-1|-1|-1|-1|-1|-1|-1|-1|-1|-1|-1|-1|-1|-1|-1|-1|-1|-1|-1|-1|-1|-1|-1|-1

[TileLayer]
03|03|03|03|02|02|02|02|-1|-1|-1|-1|-1|-1|-1|-1|-1|-1|-1|-1|-1|-1|-1|-1|-1|-1|-1|-1|-1|-1|-1|-1|-1|-1|-1|-1|-1|-1|-1|-1|-1|-1|02|02|02|02|03|03|03|03
03|03|03|03|02|02|02|02|05|-1|-1|-1|-1|-1|-1|-1|-1|-1|-1|-1|-1|-1|-1|-1|-1|-1|-1|-1|-1|-1|-1|-1|-1|-1|-1|-1|-1|-1|-1|-1|-1|-1|02|02|02|02|03|03|03|03
03|03|03|03|02|02|02|02|01|01|01|01|01|01|01|06|-1|-1|-1|-1|-1|-1|-1|-1|-1|-1|-1|-1|-1|-1|-1|-1|-1|-1|-1|-1|-1|-1|-1|-1|-1|-1|02|02|02|02|03|03|03|03
03|03|03|03|02|02|02|02|-1|-1|02|-1|-1|02|-1|06|06|-1|-1|-1|-1|-1|-1|-1|-1|-1|-1|-1|-1|-1|-1|-1|-1|-1|-1|-1|-1|-1|-1|-1|-1|-1|02|02|02|02|03|03|03|03
03|03|03|03|02|02|02|02|-1|-1|02|-1|-1|02|-1|-1|06|06|-1|-1|-1|-1|-1|-1|-1|-1|-1|-1|-1|-1|-1|-1|-1|-1|-1|-1|-1|-1|-1|-1|-1|-1|02|02|02|02|03|03|03|03
03|03|03|03|02|02|02|02|-1|-1|02|-1|-1|02|-1|-1|-1|06|06|-1|-1|-1|-1|-1|-1|-1|-1|-1|-1|-1|-1|-1|-1|-1|-1|-1|-1|-1|-1|-1|-1|-1|02|02|02|02|03|03|03|03
03|03|03|03|02|02|02|02|02|02|02|02|02|02|02|02|02|02|06|06|01|01|01|01|01|01|01|01|01|01|01|01|01|01|01|01|01|01|01|01|-1|-1|02|02|02|02|03|03|03|03
03|03|03|03|02|02|02|02|02|02|02|02|02|02|02|02|02|02|02|02|02|01|01|01|01|01|01|01|01|01|01|01|01|01|01|01|01|01|01|01|-1|-1|02|02|02|02|03|03|03|03
03|03|03|03|02|02|02|02|-1|-1|-1|-1|-1|-1|-1|-1|-1|-1|-1|-1|-1|-1|-1|-1|-1|-1|-1|-1|-1|-1|-1|-1|-1|-1|-1|-1|-1|-1|-1|-1|-1|-1|02|02|02|02|03|03|03|03
03|03|03|03|02|02|02|02|-1|-1|-1|-1|-1|-1|-1|-1|-1|-1|-1|-1|-1|-1|-1|-1|-1|-1|-1|-1|-1|-1|-1|-1|-1|-1|-1|-1|-1|-1|-1|-1|-1|-1|02|02|02|02|03|03|03|03
03|03|03|03|02|02|02|02|-1|-1|-1|-1|-1|-1|-1|-1|-1|-1|-1|-1|-1|-1|-1|-1|-1|-1|-1|-1|-1|-1|-1|-1|-1|-1|-1|-1|-1|-1|-1|-1|-1|-1|02|02|02|02|03|03|03|03
03|03|03|03|02|02|02|02|-1|-1|-1|-1|-1|-1|-1|-1|-1|-1|-1|-1|-1|-1|-1|-1|-1|-1|-1|-1|-1|-1|-1|-1|-1|-1|-1|-1|-1|-1|-1|-1|-1|-1|02|02|02|02|03|03|03|03
03|03|03|03|02|02|02|02|-1|-1|-1|-1|-1|-1|-1|-1|-1|-1|-1|-1|-1|-1|-1|-1|-1|-1|-1|-1|-1|-1|-1|-1|-1|-1|-1|-1|-1|-1|-1|-1|-1|-1|02|02|02|02|03|03|03|03
03|03|03|03|02|02|02|02|-1|-1|-1|-1|-1|01|01|01|-1|-1|01|01|01|-1|-1|01|01|01|01|-1|-1|01|01|01|-1|-1|01|01|01|01|-1|01|01|01|02|02|02|02|03|03|03|03
03|03|03|03|02|02|02|02|-1|-1|-1|-1|01|01|-1|02|-1|-1|02|-1|-1|-1|-1|-1|-1|-1|-1|-1|-1|-1|-1|-1|-1|-1|-1|-1|-1|-1|-1|01|-1|-1|02|02|02|02|03|03|03|03
03|03|03|03|02|02|02|02|-1|01|01|01|01|-1|-1|02|-1|-1|02|-1|-1|-1|-1|-1|-1|-1|-1|-1|-1|-1|-1|-1|-1|-1|-1|-1|-1|-1|01|01|-1|-1|02|02|02|02|03|03|03|03
03|03|03|03|02|02|02|02|01|01|-1|-1|-1|-1|-1|02|-1|-1|02|-1|-1|-1|-1|-1|-1|-1|-1|-1|-1|-1|01|01|01|01|01|01|01|01|01|02|-1|-1|02|02|02|02|03|03|03|03
03|03|03|03|02|02|02|02|-1|01|01|-1|-1|-1|-1|02|-1|-1|02|-1|-1|-1|-1|-1|01|01|01|01|01|01|01|-1|-1|-1|-1|-1|-1|-1|-1|02|-1|-1|02|02|02|02|03|03|03|03
03|03|03|03|02|02|02|02|-1|-1|01|01|-1|-1|-1|02|-1|-1|02|-1|-1|-1|-1|01|01|-1|-1|-1|-1|-1|-1|-1|-1|-1|-1|-1|-1|-1|-1|02|-1|-1|02|02|02|02|03|03|03|03
03|03|03|03|02|02|02|02|-1|-1|02|01|01|-1|-1|02|-1|-1|02|-1|-1|-1|01|01|-1|-1|-1|01|01|01|01|01|01|01|01|01|01|01|01|01|-1|-1|02|02|02|02|03|03|03|03
03|03|03|03|02|02|02|02|-1|-1|02|02|01|01|-1|02|-1|-1|02|-1|01|01|01|-1|-1|-1|-1|-1|-1|-1|-1|-1|-1|-1|-1|-1|-1|-1|-1|-1|-1|-1|02|02|02|02|03|03|03|03
03|03|03|03|02|02|02|02|-1|-1|02|02|-1|01|01|01|-1|-1|01|01|01|-1|-1|-1|-1|01|01|01|01|01|01|01|01|01|01|01|01|01|01|-1|-1|-1|02|02|02|02|03|03|03|03
03|03|03|03|02|02|02|02|-1|-1|02|02|-1|-1|-1|-1|-1|-1|-1|-1|-1|-1|-1|-1|-1|-1|-1|-1|-1|-1|-1|-1|-1|-1|-1|-1|-1|-1|01|-1|-1|-1|02|02|02|02|03|03|03|03
03|03|03|03|02|02|02|02|-1|-1|02|02|-1|-1|-1|-1|-1|-1|-1|-1|-1|-1|01|01|01|01|01|01|01|01|01|01|01|01|01|01|01|01|01|-1|-1|-1|02|02|02|02|03|03|03|03
03|03|03|03|02|02|02|02|-1|-1|02|02|-1|-1|-1|-1|-1|-1|-1|-1|-1|-1|-1|-1|-1|-1|-1|-1|-1|-1|-1|-1|-1|-1|-1|-1|-1|-1|01|-1|-1|-1|02|02|02|02|03|03|03|03
03|03|03|03|02|02|02|02|01|01|01|01|01|01|01|01|01|01|01|01|01|01|01|01|01|01|01|01|01|01|01|01|01|01|01|01|01|01|01|-1|-1|-1|02|02|02|02|03|03|03|03
03|03|03|03|02|02|02|02|-1|-1|-1|-1|-1|-1|-1|-1|-1|-1|-1|-1|-1|-1|-1|-1|-1|-1|-1|-1|-1|-1|-1|-1|-1|-1|-1|-1|-1|-1|-1|-1|-1|-1|02|02|02|02|03|03|03|03
03|03|03|03|02|02|02|02|-1|-1|-1|-1|-1|-1|-1|-1|-1|-1|-1|-1|-1|-1|-1|-1|-1|-1|-1|-1|-1|-1|-1|-1|-1|-1|-1|-1|-1|-1|-1|-1|-1|-1|02|02|02|02|03|03|03|03
03|03|03|03|02|02|02|02|-1|-1|-1|-1|-1|-1|-1|-1|-1|-1|-1|-1|-1|-1|-1|-1|-1|-1|-1|-1|-1|-1|-1|-1|-1|-1|-1|-1|-1|-1|-1|-1|-1|-1|02|02|02|02|03|03|03|03
03|03|03|03|02|02|02|02|-1|-1|-1|-1|-1|-1|-1|-1|-1|-1|-1|-1|-1|-1|-1|-1|-1|-1|-1|-1|-1|-1|01|01|-1|-1|-1|-1|-1|-1|01|01|01|01|02|02|02|02|03|03|03|03
03|03|03|03|02|02|02|02|-1|-1|-1|-1|-1|-1|01|01|-1|-1|-1|-1|-1|-1|01|01|-1|-1|-1|-1|-1|-1|01|01|-1|-1|01|01|-1|-1|02|-1|-1|-1|02|02|02|02|03|03|03|03
03|03|03|03|02|02|02|02|-1|-1|01|01|-1|-1|01|01|-1|-1|01|01|-1|-1|01|01|-1|-1|01|01|-1|-1|-1|-1|-1|-1|01|01|-1|-1|02|02|-1|-1|02|02|02|02|03|03|03|03
03|03|03|03|02|02|02|02|-1|-1|01|01|-1|-1|-1|-1|-1|-1|01|01|-1|-1|-1|-1|-1|-1|01|01|-1|-1|-1|-1|-1|-1|-1|-1|-1|-1|-1|02|02|-1|02|02|02|02|03|03|03|03
03|03|03|03|02|02|02|02|-1|-1|02|06|06|-1|-1|-1|-1|-1|-1|06|-1|-1|-1|-1|-1|-1|-1|-1|-1|-1|-1|-1|-1|-1|-1|-1|-1|-1|-1|-1|02|02|02|02|02|02|03|03|03|03
03|03|03|03|02|02|02|02|-1|-1|02|-1|06|06|-1|-1|-1|-1|-1|06|-1|-1|-1|-1|-1|-1|-1|-1|-1|-1|-1|-1|-1|-1|-1|-1|-1|-1|-1|-1|-1|-1|02|02|02|02|03|03|03|03
03|03|03|03|02|02|02|02|-1|-1|02|-1|-1|06|06|-1|-1|-1|-1|06|-1|-1|-1|-1|-1|-1|-1|-1|-1|-1|-1|-1|-1|-1|-1|-1|-1|-1|-1|-1|-1|-1|02|02|02|02|03|03|03|03
03|03|03|03|02|02|02|02|-1|-1|02|-1|-1|02|06|06|-1|-1|-1|06|06|06|06|06|06|06|06|06|06|06|06|06|06|06|06|06|06|06|06|06|-1|-1|02|02|02|02|03|03|03|03
03|03|03|03|02|02|02|02|-1|-1|02|-1|-1|02|-1|06|06|-1|-1|-1|-1|-1|-1|-1|-1|-1|-1|-1|-1|-1|-1|-1|-1|-1|-1|-1|-1|-1|-1|-1|-1|-1|02|02|02|02|03|03|03|03
03|03|03|03|02|02|02|02|-1|-1|02|-1|-1|02|-1|-1|06|06|-1|-1|-1|-1|-1|-1|-1|-1|-1|-1|-1|-1|-1|-1|-1|-1|-1|-1|-1|-1|-1|-1|-1|-1|02|02|02|02|03|03|03|03
03|03|03|03|02|02|02|02|-1|-1|02|-1|-1|02|-1|-1|02|06|06|-1|-1|-1|-1|-1|02|02|-1|02|02|-1|02|02|-1|-1|02|02|-1|-1|02|02|-1|-1|02|02|02|02|03|03|03|03
03|03|03|03|02|02|02|02|-1|-1|02|02|02|02|02|02|02|02|06|06|06|06|06|06|06|06|06|06|06|06|06|06|06|06|06|06|06|06|06|06|06|06|02|02|02|02|03|03|03|03
03|03|03|03|02|02|02|02|-1|-1|-1|-1|-1|-1|-1|-1|-1|-1|-1|-1|-1|-1|-1|-1|-1|-1|-1|-1|-1|-1|-1|-1|-1|-1|-1|-1|-1|-1|-1|-1|-1|-1|02|02|02|02|03|03|03|03
03|03|03|03|02|02|02|02|-1|-1|-1|-1|-1|-1|-1|-1|-1|-1|-1|-1|-1|-1|-1|-1|-1|-1|-1|-1|-1|-1|-1|-1|-1|-1|-1|-1|-1|-1|-1|-1|-1|-1|02|02|02|02|03|03|03|03
03|03|03|03|02|02|02|02|06|06|06|-1|-1|-1|-1|-1|-1|-1|-1|-1|-1|-1|-1|-1|-1|-1|-1|-1|-1|-1|-1|-1|-1|-1|-1|-1|-1|-1|-1|-1|-1|-1|02|02|02|02|03|03|03|03
03|03|03|03|02|02|02|02|02|02|06|06|-1|-1|-1|-1|-1|-1|-1|-1|-1|-1|-1|-1|-1|-1|-1|-1|-1|-1|-1|-1|-1|-1|-1|-1|-1|-1|-1|-1|-1|-1|02|02|02|02|03|03|03|03
03|03|03|03|02|02|02|02|02|02|02|06|06|-1|-1|-1|-1|-1|-1|-1|-1|-1|-1|-1|-1|-1|-1|-1|-1|-1|-1|-1|-1|-1|-1|-1|-1|-1|-1|-1|-1|-1|02|02|02|02|03|03|03|03
03|03|03|03|02|02|02|02|02|02|02|02|06|06|-1|-1|-1|-1|-1|-1|-1|-1|-1|-1|-1|-1|-1|-1|-1|-1|-1|-1|-1|-1|-1|-1|-1|-1|-1|-1|-1|04|02|02|02|02|03|03|03|03
03|03|03|03|02|02|02|02|01|01|01|01|01|01|01|01|01|01|01|01|01|01|01|01|01|01|01|01|01|01|01|01|01|01|01|01|01|01|01|01|01|01|02|02|02|02|03|03|03|03
03|03|03|03|02|02|02|02|02|02|02|02|02|02|02|02|02|02|02|02|02|02|02|02|02|02|02|02|02|02|02|02|02|02|02|02|02|02|02|02|02|02|02|02|02|02|03|03|03|03
03|03|03|03|02|02|02|02|03|03|03|03|03|03|03|03|03|03|03|03|03|03|03|03|03|03|03|03|03|03|03|03|03|03|03|03|03|03|03|03|03|03|02|02|02|02|03|03|03|03

[CollisionLayer]
-1|-1|-1|-1|-1|-1|-1|-2|-1|-1|-1|-1|-1|-1|-1|-1|-1|-1|-1|-1|-1|-1|-1|-1|-1|-1|-1|-1|-1|-1|-1|-1|-1|-1|-1|-1|-1|-1|-1|-1|-1|-1|-2|-1|-1|-1|-1|-1|-1|-1
-1|-1|-1|-1|-1|-1|-1|-2|-1|-3|-1|-1|-1|-1|-1|-1|-1|-1|-1|-1|-1|-1|-1|-1|-1|-1|-1|-1|-1|-1|-1|-1|-1|-1|-1|-1|-1|-1|-1|-1|-1|-1|-2|-1|-1|-1|-1|-1|-1|-1
-1|-1|-1|-1|-1|-1|-1|-2|-2|-2|-2|-2|-2|-2|-2|-2|-1|-1|-1|-1|-1|-1|-1|-1|-1|-1|-1|-1|-1|-1|-1|-1|-1|-1|-1|-1|-1|-1|-1|-1|-1|-1|-2|-1|-1|-1|-1|-1|-1|-1
-1|-1|-1|-1|-1|-1|-1|-2|-1|-1|-1|-1|-1|-1|-1|-2|-2|-1|-1|-1|-1|-1|-1|-1|-1|-1|-1|-1|-1|-1|-1|-1|-1|-1|-1|-1|-1|-1|-1|-1|-1|-1|-2|-1|-1|-1|-1|-1|-1|-1
-1|-1|-1|-1|-1|-1|-1|-2|-1|-1|-1|-1|-1|-1|-1|-1|-2|-2|-1|-1|-1|-1|-1|-1|-1|-1|-1|-1|-1|-1|-1|-1|-1|-1|-1|-1|-1|-1|-1|-1|-1|-1|-2|-1|-1|-1|-1|-1|-1|-1
-1|-1|-1|-1|-1|-1|-1|-2|-1|-1|-1|-1|-1|-1|-1|-1|-1|-2|-2|-1|-1|-1|-1|-1|-1|-1|-1|-1|-1|-1|-1|-1|-1|-1|-1|-1|-1|-1|-1|-1|-1|-1|-2|-1|-1|-1|-1|-1|-1|-1
-1|-1|-1|-1|-1|-1|-1|-2|-1|-1|-1|-1|-1|-1|-1|-1|-1|-1|-2|-2|-2|-2|-2|-2|-2|-2|-2|-2|-2|-2|-2|-2|-2|-2|-2|-2|-2|-2|-2|-2|-1|-1|-2|-1|-1|-1|-1|-1|-1|-1
-1|-1|-1|-1|-1|-1|-1|-2|-2|-2|-2|-2|-2|-2|-2|-2|-2|-2|-2|-2|-2|-2|-2|-2|-2|-2|-2|-2|-2|-2|-2|-2|-2|-2|-2|-2|-2|-2|-2|-2|-1|-1|-2|-1|-1|-1|-1|-1|-1|-1
-1|-1|-1|-1|-1|-1|-1|-2|-1|-1|-1|-1|-1|-1|-1|-1|-1|-1|-1|-1|-1|-1|-1|-1|-1|-1|-1|-1|-1|-1|-1|-1|-1|-1|-1|-1|-1|-1|-1|-1|-1|-1|-2|-1|-1|-1|-1|-1|-1|-1
-1|-1|-1|-1|-1|-1|-1|-2|-1|-1|-1|-1|-1|-1|-1|-1|-1|-1|-1|-1|-1|-1|-1|-1|-1|-1|-1|-1|-1|-1|-1|-1|-1|-1|-1|-1|-1|-1|-1|-1|-1|-1|-2|-1|-1|-1|-1|-1|-1|-1
-1|-1|-1|-1|-1|-1|-1|-2|-1|-1|-1|-1|-1|-1|-1|-1|-1|-1|-1|-1|-1|-1|-1|-1|-1|-1|-1|-1|-1|-1|-1|-1|-1|-1|-1|-1|-1|-1|-1|-1|-1|-1|-2|-1|-1|-1|-1|-1|-1|-1
-1|-1|-1|-1|-1|-1|-1|-2|-1|-1|-1|-1|-1|-1|-1|-1|-1|-1|-1|-1|-1|-1|-1|-1|-1|-1|-1|-1|-1|-1|-1|-1|-1|-1|-1|-1|-1|-1|-1|-1|-1|-1|-2|-1|-1|-1|-1|-1|-1|-1
-1|-1|-1|-1|-1|-1|-1|-2|-1|-1|-1|-1|-1|-1|-1|-1|-1|-1|-1|-1|-1|-1|-1|-1|-1|-1|-1|-1|-1|-1|-1|-1|-1|-1|-1|-1|-1|-1|-1|-1|-1|-1|-2|-1|-1|-1|-1|-1|-1|-1
-1|-1|-1|-1|-1|-1|-1|-2|-1|-1|-1|-1|-1|-2|-2|-2|-1|-1|-2|-2|-2|-1|-1|-2|-2|-2|-2|-1|-1|-2|-2|-2|-1|-1|-2|-2|-2|-2|-1|-2|-2|-2|-2|-1|-1|-1|-1|-1|-1|-1
-1|-1|-1|-1|-1|-1|-1|-2|-1|-1|-1|-1|-2|-2|-1|-2|-1|-1|-2|-1|-1|-1|-1|-1|-1|-1|-1|-1|-1|-1|-1|-1|-1|-1|-1|-1|-1|-1|-1|-2|-1|-1|-2|-1|-1|-1|-1|-1|-1|-1
-1|-1|-1|-1|-1|-1|-1|-2|-1|-2|-2|-2|-2|-1|-1|-2|-1|-1|-2|-1|-1|-1|-1|-1|-1|-1|-1|-1|-1|-1|-1|-1|-1|-1|-1|-1|-1|-1|-2|-2|-1|-1|-2|-1|-1|-1|-1|-1|-1|-1
-1|-1|-1|-1|-1|-1|-1|-2|-2|-2|-1|-1|-1|-1|-1|-2|-1|-1|-2|-1|-1|-1|-1|-1|-1|-1|-1|-1|-1|-1|-2|-2|-2|-2|-2|-2|-2|-2|-2|-2|-1|-1|-2|-1|-1|-1|-1|-1|-1|-1
-1|-1|-1|-1|-1|-1|-1|-2|-1|-2|-2|-1|-1|-1|-1|-2|-1|-1|-2|-1|-1|-1|-1|-1|-2|-2|-2|-2|-2|-2|-2|-1|-1|-1|-1|-1|-1|-1|-1|-2|-1|-1|-2|-1|-1|-1|-1|-1|-1|-1
-1|-1|-1|-1|-1|-1|-1|-2|-1|-1|-2|-2|-1|-1|-1|-2|-1|-1|-2|-1|-1|-1|-1|-2|-2|-1|-1|-1|-1|-1|-1|-1|-1|-1|-1|-1|-1|-1|-1|-2|-1|-1|-2|-1|-1|-1|-1|-1|-1|-1
-1|-1|-1|-1|-1|-1|-1|-2|-1|-1|-1|-2|-2|-1|-1|-2|-1|-1|-2|-1|-1|-1|-2|-2|-1|-1|-1|-2|-2|-2|-2|-2|-2|-2|-2|-2|-2|-2|-2|-2|-1|-1|-2|-1|-1|-1|-1|-1|-1|-1
-1|-1|-1|-1|-1|-1|-1|-2|-1|-1|-1|-2|-2|-2|-1|-2|-1|-1|-2|-1|-2|-2|-2|-1|-1|-1|-1|-1|-1|-1|-1|-1|-1|-1|-1|-1|-1|-1|-1|-1|-1|-1|-2|-1|-1|-1|-1|-1|-1|-1
-1|-1|-1|-1|-1|-1|-1|-2|-1|-1|-1|-2|-1|-2|-2|-2|-1|-1|-2|-2|-2|-1|-1|-1|-1|-2|-2|-2|-2|-2|-2|-2|-2|-2|-2|-2|-2|-2|-2|-1|-1|-1|-2|-1|-1|-1|-1|-1|-1|-1
-1|-1|-1|-1|-1|-1|-1|-2|-1|-1|-1|-2|-1|-1|-1|-1|-1|-1|-1|-1|-1|-1|-1|-1|-1|-1|-1|-1|-1|-1|-1|-1|-1|-1|-1|-1|-1|-1|-2|-1|-1|-1|-2|-1|-1|-1|-1|-1|-1|-1
-1|-1|-1|-1|-1|-1|-1|-2|-1|-1|-1|-2|-1|-1|-1|-1|-1|-1|-1|-1|-1|-1|-2|-2|-2|-2|-2|-2|-2|-2|-2|-2|-2|-2|-2|-2|-2|-2|-2|-1|-1|-1|-2|-1|-1|-1|-1|-1|-1|-1
-1|-1|-1|-1|-1|-1|-1|-2|-1|-1|-1|-2|-1|-1|-1|-1|-1|-1|-1|-1|-1|-1|-1|-1|-1|-1|-1|-1|-1|-1|-1|-1|-1|-1|-1|-1|-1|-1|-2|-1|-1|-1|-2|-1|-1|-1|-1|-1|-1|-1
-1|-1|-1|-1|-1|-1|-1|-2|-2|-2|-2|-2|-2|-2|-2|-2|-2|-2|-2|-2|-2|-2|-2|-2|-2|-2|-2|-2|-2|-2|-2|-2|-2|-2|-2|-2|-2|-2|-2|-1|-1|-1|-2|-1|-1|-1|-1|-1|-1|-1
-1|-1|-1|-1|-1|-1|-1|-2|-1|-1|-1|-1|-1|-1|-1|-1|-1|-1|-1|-1|-1|-1|-1|-1|-1|-1|-1|-1|-1|-1|-1|-1|-1|-1|-1|-1|-1|-1|-1|-1|-1|-1|-2|-1|-1|-1|-1|-1|-1|-1
-1|-1|-1|-1|-1|-1|-1|-2|-1|-1|-1|-1|-1|-1|-1|-1|-1|-1|-1|-1|-1|-1|-1|-1|-1|-1|-1|-1|-1|-1|-1|-1|-1|-1|-1|-1|-1|-1|-1|-1|-1|-1|-2|-1|-1|-1|-1|-1|-1|-1
-1|-1|-1|-1|-1|-1|-1|-2|-1|-1|-1|-1|-1|-1|-1|-1|-1|-1|-1|-1|-1|-1|-1|-1|-1|-1|-1|-1|-1|-1|-1|-1|-1|-1|-1|-1|-1|-1|-1|-1|-1|-1|-2|-1|-1|-1|-1|-1|-1|-1
-1|-1|-1|-1|-1|-1|-1|-2|-1|-1|-1|-1|-1|-1|-1|-1|-1|-1|-1|-1|-1|-1|-1|-1|-1|-1|-1|-1|-1|-1|-2|-2|-1|-1|-1|-1|-1|-1|-2|-2|-2|-2|-2|-1|-1|-1|-1|-1|-1|-1
-1|-1|-1|-1|-1|-1|-1|-2|-1|-1|-1|-1|-1|-1|-2|-2|-1|-1|-1|-1|-1|-1|-2|-2|-1|-1|-1|-1|-1|-1|-2|-2|-1|-1|-2|-2|-1|-1|-2|-1|-1|-1|-2|-1|-1|-1|-1|-1|-1|-1
-1|-1|-1|-1|-1|-1|-1|-2|-1|-1|-2|-2|-1|-1|-2|-2|-1|-1|-2|-2|-1|-1|-2|-2|-1|-1|-2|-2|-1|-1|-1|-1|-1|-1|-2|-2|-1|-1|-2|-2|-1|-1|-2|-1|-1|-1|-1|-1|-1|-1
-1|-1|-1|-1|-1|-1|-1|-2|-1|-1|-2|-2|-1|-1|-1|-1|-1|-1|-2|-2|-1|-1|-1|-1|-1|-1|-2|-2|-1|-1|-1|-1|-1|-1|-1|-1|-1|-1|-1|-2|-2|-1|-2|-1|-1|-1|-1|-1|-1|-1
-1|-1|-1|-1|-1|-1|-1|-2|-1|-1|-2|-2|-2|-1|-1|-1|-1|-1|-1|-2|-1|-1|-1|-1|-1|-1|-1|-1|-1|-1|-1|-1|-1|-1|-1|-1|-1|-1|-1|-1|-2|-2|-2|-1|-1|-1|-1|-1|-1|-1
-1|-1|-1|-1|-1|-1|-1|-2|-1|-1|-2|-1|-2|-2|-1|-1|-1|-1|-1|-2|-1|-1|-1|-1|-1|-1|-1|-1|-1|-1|-1|-1|-1|-1|-1|-1|-1|-1|-1|-1|-1|-1|-2|-1|-1|-1|-1|-1|-1|-1
-1|-1|-1|-1|-1|-1|-1|-2|-1|-1|-2|-1|-1|-2|-2|-1|-1|-1|-1|-2|-1|-1|-1|-1|-1|-1|-1|-1|-1|-1|-1|-1|-1|-1|-1|-1|-1|-1|-1|-1|-1|-1|-2|-1|-1|-1|-1|-1|-1|-1
-1|-1|-1|-1|-1|-1|-1|-2|-1|-1|-2|-1|-1|-1|-2|-2|-1|-1|-1|-2|-2|-2|-2|-2|-2|-2|-2|-2|-2|-2|-2|-2|-2|-2|-2|-2|-2|-2|-2|-2|-1|-1|-2|-1|-1|-1|-1|-1|-1|-1
-1|-1|-1|-1|-1|-1|-1|-2|-1|-1|-2|-1|-1|-1|-1|-2|-2|-1|-1|-1|-1|-1|-1|-1|-1|-1|-1|-1|-1|-1|-1|-1|-1|-1|-1|-1|-1|-1|-1|-1|-1|-1|-2|-1|-1|-1|-1|-1|-1|-1
-1|-1|-1|-1|-1|-1|-1|-2|-1|-1|-2|-1|-1|-1|-1|-1|-2|-2|-1|-1|-1|-1|-1|-1|-1|-1|-1|-1|-1|-1|-1|-1|-1|-1|-1|-1|-1|-1|-1|-1|-1|-1|-2|-1|-1|-1|-1|-1|-1|-1
-1|-1|-1|-1|-1|-1|-1|-2|-1|-1|-2|-1|-1|-1|-1|-1|-2|-2|-2|-1|-1|-1|-1|-1|-2|-2|-1|-2|-2|-1|-2|-2|-1|-1|-2|-2|-1|-1|-2|-2|-1|-1|-2|-1|-1|-1|-1|-1|-1|-1
-1|-1|-1|-1|-1|-1|-1|-2|-1|-1|-2|-2|-2|-2|-2|-2|-2|-2|-2|-2|-2|-2|-2|-2|-2|-2|-2|-2|-2|-2|-2|-2|-2|-2|-2|-2|-2|-2|-2|-2|-2|-2|-2|-1|-1|-1|-1|-1|-1|-1
-1|-1|-1|-1|-1|-1|-1|-2|-1|-1|-1|-1|-1|-1|-1|-1|-1|-1|-1|-1|-1|-1|-1|-1|-1|-1|-1|-1|-1|-1|-1|-1|-1|-1|-1|-1|-1|-1|-1|-1|-1|-1|-2|-1|-1|-1|-1|-1|-1|-1
-1|-1|-1|-1|-1|-1|-1|-2|-1|-1|-1|-1|-1|-1|-1|-1|-1|-1|-1|-1|-1|-1|-1|-1|-1|-1|-1|-1|-1|-1|-1|-1|-1|-1|-1|-1|-1|-1|-1|-1|-1|-1|-2|-1|-1|-1|-1|-1|-1|-1
-1|-1|-1|-1|-1|-1|-1|-2|-2|-2|-2|-1|-1|-1|-1|-1|-1|-1|-1|-1|-1|-1|-1|-1|-1|-1|-1|-1|-1|-1|-1|-1|-1|-1|-1|-1|-1|-1|-1|-1|-1|-1|-2|-1|-1|-1|-1|-1|-1|-1
-1|-1|-1|-1|-1|-1|-1|-2|-1|-1|-2|-2|-1|-1|-1|-1|-1|-1|-1|-1|-1|-1|-1|-1|-1|-1|-1|-1|-1|-1|-1|-1|-1|-1|-1|-1|-1|-1|-1|-1|-1|-1|-2|-1|-1|-1|-1|-1|-1|-1
-1|-1|-1|-1|-1|-1|-1|-2|-1|-1|-1|-2|-2|-1|-1|-1|-1|-1|-1|-1|-1|-1|-1|-1|-1|-1|-1|-1|-1|-1|-1|-1|-1|-1|-1|-1|-1|-1|-1|-1|-1|-1|-2|-1|-1|-1|-1|-1|-1|-1
-1|-1|-1|-1|-1|-1|-1|-2|-1|-1|-1|-1|-2|-2|-1|-1|-1|-1|-1|-1|-1|-1|-1|-1|-1|-1|-1|-1|-1|-1|-1|-1|-1|-1|-1|-1|-1|-1|-1|-1|-1|01|-2|-1|-1|-1|-1|-1|-1|-1
-1|-1|-1|-1|-1|-1|-1|-2|-1|-1|-1|-1|-1|-2|-2|-2|-2|-2|-2|-2|-2|-2|-2|-2|-2|-2|-2|-2|-2|-2|-2|-2|-2|-2|-2|-2|-2|-2|-2|-2|-2|-2|-2|-1|-1|-1|-1|-1|-1|-1
-1|-1|-1|-1|-1|-1|-1|-2|-1|-1|-1|-1|-1|-1|-1|-1|-1|-1|-1|-1|-1|-1|-1|-1|-1|-1|-1|-1|-1|-1|-1|-1|-1|-1|-1|-1|-1|-1|-1|-1|-1|-1|-2|-1|-1|-1|-1|-1|-1|-1
-1|-1|-1|-1|-1|-1|-1|-2|-1|-1|-1|-1|-1|-1|-1|-1|-1|-1|-1|-1|-1|-1|-1|-1|-1|-1|-1|-1|-1|-1|-1|-1|-1|-1|-1|-1|-1|-1|-1|-1|-1|-1|-2|-1|-1|-1|-1|-1|-1|-1
