[Demensions]
7x7

[TileDemensions]
64x64

[Textures]
Inside\Floors\Tile_Grey 64 64
Background\Dirt 64 64
Background\Water 64 64

[Entrances]

[TileLayer]
02|02|02|02|02|02|02
02|01|01|01|01|01|02
02|01|00|00|00|01|02
02|01|00|00|00|01|02
02|01|01|00|01|01|02
02|02|01|00|01|02|02
02|02|01|00|01|02|02

[CollisionLayer]
-2|-2|-2|-2|-2|-2|-2
-2|-1|-1|-1|-1|-1|-2
-2|-1|-1|-1|-1|-1|-2
-2|-1|-1|-1|-1|-1|-2
-2|-1|-1|-1|-1|-1|-2
-2|-2|-1|-1|-1|-2|-2
-2|-2|-1|-3|-1|-2|-2
