[Type]
OverWorld

[Demensions]
7x7

[TileDemensions]
64x64

[Textures]
Inside\Floors\Tile_Grey 64 64
Background\Dirt 64 64
Background\Water 64 64
Dungeon\DungeonDoor 64 64

[Entrances]
TileMaps\overworld.map

[NPCs]
TheScrumMaster Centre 25 50

[TileLayer]
02|02|02|02|02|02|02
02|01|01|01|01|01|02
02|01|00|00|00|01|02
02|01|00|00|00|01|02
02|01|01|00|01|01|02
02|02|01|00|01|02|02
02|02|01|00|01|02|02

[TileLayer]
-1|-1|-1|-1|-1|-1|-1
-1|-1|-1|-1|-1|03|-1
-1|-1|-1|-1|-1|-1|-1
-1|-1|-1|-1|-1|-1|-1
-1|-1|-1|-1|-1|-1|-1
-1|-1|-1|-1|-1|-1|-1
-1|-1|-1|-1|-1|-1|-1

[CollisionLayer]
-2|-2|-2|-2|-2|-2|-2
-2|-1|-1|-1|-1|00|-2
-2|-1|-1|-1|-1|-1|-2
-2|-1|-1|-1|-1|-1|-2
-2|-1|-1|-1|-1|-1|-2
-2|-2|-1|-1|-1|-2|-2
-2|-2|-1|-3|-1|-2|-2

[NPCLayer]
-1|-1|-1|-1|-1|-1|-1
-1|-1|-1|00|-1|-1|-1
-1|-1|-1|-1|-1|-1|-1
-1|-1|-1|-1|-1|-1|-1
-1|-1|-1|-1|-1|-1|-1
-1|-1|-1|-1|-1|-1|-1
-1|-1|-1|-1|-1|-1|-1
