[Demensions]
20x50

[TileDemensions]
64x64

[Textures]
Background\Dirt 64 64
Background\Road 64 64
Background\Water 64 64
Dungeon\Fin 64 64
Dungeon\Start 64 64
Dungeon\Tree\Bark1 64 64
Dungeon\Tree\Bark2 64 64
Dungeon\Tree\Bark3 64 64
Inside\Furni\Book1 64 64
Inside\Floors\Tile_Grey 64 64
Inside\Floors\Wood 64 64
Inside\Floors\Tile_Blue 64 64
Inside\Floors\Tile_Green 64 64
Inside\Floors\Tile_Orange 64 64
Inside\Floors\Tile_Purple 64 64
Inside\Floors\Tile_Red 64 64

[Entrances]
collisionBlock

[TileLayer]
00|00|00|00|00|00|00|00|00|00|00|00|00|00|00|00|00|00|00|00
00|00|00|00|00|00|00|00|00|00|00|00|00|00|00|00|00|00|00|00
00|00|00|00|00|00|00|00|00|00|00|00|00|00|00|00|00|00|00|00
00|00|00|00|00|00|00|00|00|00|00|00|00|00|00|00|00|00|00|00
00|00|00|00|00|00|00|00|00|00|00|00|00|00|00|00|00|00|00|00
00|00|00|00|00|00|00|00|00|00|00|00|00|00|00|00|00|00|00|00
00|00|00|00|00|00|00|00|00|00|00|00|00|00|00|00|00|00|00|00
09|09|09|09|09|09|09|09|09|09|09|09|09|09|09|09|09|09|09|09
09|09|09|09|09|09|09|09|09|09|09|09|09|09|09|09|09|09|09|09
09|09|09|09|09|09|09|09|09|09|09|09|09|09|09|09|09|09|09|09
09|09|09|09|09|09|09|09|09|09|09|09|09|09|09|09|09|09|09|09
09|09|09|09|09|09|09|09|09|09|09|09|09|09|09|09|09|09|09|09
09|09|09|09|09|09|09|09|09|09|09|09|09|09|09|09|09|09|09|09
09|09|09|09|09|09|09|09|09|09|09|09|09|09|09|09|09|09|09|09
09|09|09|09|09|09|09|09|09|09|09|09|09|09|09|09|09|09|09|09
09|09|09|09|09|09|09|09|09|09|09|09|09|09|09|09|09|09|09|09
09|09|09|09|09|09|09|09|09|09|09|09|09|09|09|09|09|09|09|09
05|05|06|06|06|06|06|06|06|06|06|06|06|06|06|06|06|06|05|05
05|05|06|06|06|06|06|06|06|06|06|06|06|06|06|06|06|06|05|05
05|05|06|06|06|06|06|06|06|06|06|06|06|06|06|06|06|06|05|05
05|05|06|06|06|06|06|06|06|06|06|06|06|06|06|06|06|06|05|05
05|05|06|06|06|06|06|06|06|06|06|06|06|06|06|06|06|06|05|05
05|05|06|06|06|06|06|06|06|06|06|06|06|06|06|06|06|06|05|05
05|05|06|06|06|06|06|06|06|06|06|06|06|06|06|06|06|06|05|05
05|05|06|06|06|06|06|06|06|06|06|06|06|06|06|06|06|06|05|05
05|05|06|06|06|06|06|06|06|06|06|06|06|06|06|06|06|06|05|05
05|05|06|06|06|06|06|06|06|06|06|06|06|06|06|06|06|06|05|05
05|05|06|06|06|06|06|06|06|06|06|06|06|06|06|06|06|06|05|05
05|05|06|06|06|06|06|06|06|06|06|06|06|06|06|06|06|06|05|05
02|02|02|02|02|02|02|02|02|02|02|02|02|02|02|02|02|02|02|02
02|02|02|02|02|02|02|02|02|02|02|02|02|02|02|02|02|02|02|02
02|02|02|02|02|02|02|02|02|02|02|02|02|02|02|02|02|02|02|02
02|02|02|02|02|02|02|02|02|02|02|02|02|02|02|02|02|02|02|02
02|02|02|02|02|02|02|02|02|02|02|02|02|02|02|02|02|02|02|02
02|02|02|02|02|02|02|02|02|02|02|02|02|02|02|02|02|02|02|02
02|02|02|02|02|02|02|02|02|02|02|02|02|02|02|02|02|02|02|02
02|02|02|02|02|02|02|02|02|02|02|02|02|02|02|02|02|02|02|02
02|02|02|02|02|02|02|02|02|02|02|02|02|02|02|02|02|02|02|02
02|09|09|09|09|09|09|09|09|09|09|09|09|09|09|09|09|09|09|09
02|09|09|09|09|09|09|09|09|09|09|09|09|09|09|09|09|09|09|09
02|09|09|09|09|09|09|09|09|09|09|09|09|09|09|09|09|09|09|09
02|09|09|09|09|09|09|09|09|09|09|09|09|09|09|09|09|09|09|09
02|09|02|09|09|09|09|09|09|09|09|09|09|09|09|09|09|09|09|09
02|02|02|09|09|09|09|09|09|09|09|09|09|09|09|09|09|09|09|09
09|09|09|09|09|09|09|09|09|09|09|09|09|09|09|09|09|09|09|09
09|09|09|09|09|09|09|09|09|09|09|09|09|09|09|09|09|09|09|09
09|09|09|09|09|09|09|09|09|09|09|09|09|09|09|09|09|09|09|09
09|09|09|09|09|09|09|09|09|09|09|09|09|09|09|09|09|09|09|09
09|09|09|09|09|09|09|09|09|09|09|09|09|09|09|09|09|09|09|09
09|09|09|09|09|09|09|09|09|09|09|09|09|09|09|09|09|09|09|09

[TileLayer]
-1|-1|-1|-1|-1|-1|-1|-1|-1|-1|-1|-1|-1|-1|-1|-1|-1|-1|01|01
-1|-1|-1|-1|-1|-1|-1|-1|-1|-1|-1|-1|-1|-1|-1|-1|-1|-1|01|01
04|-1|01|-1|01|-1|01|-1|01|01|01|-1|01|01|-1|01|-1|-1|01|01
-1|-1|-1|-1|-1|-1|-1|-1|-1|01|-1|-1|-1|-1|-1|01|-1|-1|01|01
01|01|-1|-1|-1|-1|-1|-1|-1|01|-1|-1|-1|-1|-1|01|-1|-1|01|01
01|01|01|-1|-1|-1|-1|-1|-1|-1|-1|-1|-1|-1|-1|01|-1|-1|01|01
01|01|01|01|01|01|01|01|01|01|01|01|01|01|01|01|-1|-1|01|01
01|01|01|01|01|01|01|01|01|-1|-1|-1|-1|-1|-1|-1|-1|-1|01|01
01|01|01|01|01|01|01|01|01|-1|-1|-1|-1|-1|-1|-1|-1|-1|01|01
01|01|-1|-1|-1|-1|-1|-1|-1|-1|-1|-1|-1|-1|-1|-1|-1|-1|01|01
01|01|-1|-1|-1|-1|-1|-1|-1|-1|-1|-1|-1|-1|-1|-1|-1|-1|01|01
01|01|-1|-1|-1|-1|10|10|-1|-1|-1|-1|-1|-1|-1|-1|-1|-1|01|01
01|01|-1|-1|-1|-1|-1|-1|-1|-1|-1|-1|-1|-1|-1|-1|-1|-1|01|01
01|01|10|10|10|-1|-1|-1|-1|-1|-1|-1|-1|-1|-1|-1|-1|-1|01|01
01|01|-1|-1|-1|-1|-1|-1|-1|-1|-1|-1|-1|-1|-1|-1|-1|-1|01|01
01|01|-1|-1|-1|-1|-1|-1|-1|-1|-1|-1|-1|-1|-1|-1|-1|-1|01|01
01|01|-1|-1|10|10|10|10|-1|-1|-1|-1|-1|-1|-1|-1|-1|-1|01|01
-1|-1|-1|-1|-1|-1|-1|-1|-1|-1|-1|-1|-1|-1|-1|-1|-1|-1|-1|-1
-1|-1|-1|-1|-1|-1|-1|-1|-1|-1|-1|-1|-1|-1|-1|-1|-1|-1|-1|-1
07|07|07|07|07|07|07|07|-1|-1|-1|-1|-1|-1|-1|-1|-1|-1|-1|-1
-1|-1|-1|-1|-1|-1|-1|-1|-1|-1|-1|-1|-1|-1|-1|-1|-1|-1|-1|-1
-1|-1|-1|-1|-1|-1|-1|-1|-1|-1|-1|-1|-1|-1|-1|-1|-1|-1|-1|-1
-1|-1|07|07|07|07|07|07|07|07|-1|-1|-1|-1|-1|-1|-1|-1|-1|-1
-1|-1|-1|-1|-1|-1|-1|-1|-1|-1|-1|-1|-1|-1|-1|-1|-1|-1|-1|-1
-1|-1|-1|-1|-1|-1|-1|-1|-1|-1|-1|-1|-1|-1|-1|-1|-1|-1|-1|-1
07|07|07|07|07|07|07|07|-1|-1|-1|-1|-1|-1|-1|-1|-1|-1|-1|-1
-1|-1|-1|-1|-1|-1|-1|-1|-1|-1|-1|-1|-1|-1|-1|-1|-1|-1|-1|-1
-1|-1|-1|-1|-1|-1|-1|-1|-1|-1|-1|-1|-1|-1|-1|-1|-1|-1|-1|-1
-1|-1|07|07|07|07|07|07|07|07|-1|-1|-1|-1|-1|-1|-1|-1|-1|-1
-1|-1|-1|-1|-1|-1|-1|-1|-1|-1|-1|-1|-1|-1|-1|-1|-1|-1|01|01
01|01|01|01|01|01|01|01|01|-1|-1|-1|-1|-1|-1|-1|-1|-1|01|01
-1|-1|-1|-1|-1|-1|-1|-1|-1|-1|-1|-1|-1|-1|-1|-1|-1|-1|01|01
-1|01|01|01|01|01|01|01|01|01|-1|-1|-1|-1|-1|-1|-1|-1|01|01
-1|-1|-1|-1|-1|-1|-1|-1|-1|01|-1|-1|-1|-1|-1|-1|-1|-1|01|01
01|01|01|01|01|-1|-1|-1|-1|-1|-1|-1|-1|-1|-1|-1|-1|-1|01|01
-1|-1|-1|-1|-1|-1|-1|01|-1|-1|-1|-1|-1|-1|-1|-1|-1|-1|01|01
01|01|01|01|01|01|01|01|-1|-1|-1|-1|-1|-1|-1|-1|-1|-1|01|01
-1|-1|-1|-1|-1|-1|-1|-1|-1|-1|-1|-1|-1|-1|-1|-1|-1|-1|01|01
-1|01|01|01|01|01|01|01|01|01|01|01|01|01|01|01|01|01|01|01
-1|01|-1|-1|-1|-1|-1|-1|-1|-1|-1|-1|-1|-1|-1|-1|-1|-1|01|01
-1|01|-1|-1|-1|-1|-1|-1|-1|-1|-1|-1|-1|-1|-1|-1|-1|-1|01|01
-1|01|-1|-1|-1|-1|-1|-1|-1|-1|-1|-1|-1|-1|-1|-1|-1|-1|01|01
-1|01|-1|01|-1|-1|-1|-1|-1|-1|-1|-1|-1|-1|-1|-1|-1|-1|01|01
-1|-1|-1|01|-1|-1|-1|-1|-1|-1|-1|-1|-1|-1|-1|-1|-1|-1|01|01
01|01|01|01|-1|-1|-1|-1|-1|-1|-1|-1|-1|-1|-1|-1|-1|-1|01|01
-1|01|01|01|-1|-1|-1|-1|-1|-1|-1|-1|-1|-1|-1|-1|-1|-1|01|01
03|01|01|01|-1|-1|-1|-1|-1|-1|-1|-1|-1|-1|-1|-1|-1|-1|01|01
-1|01|01|01|-1|-1|-1|-1|-1|-1|-1|-1|-1|-1|-1|-1|-1|-1|01|01
-1|-1|-1|-1|-1|-1|-1|-1|-1|-1|-1|-1|-1|-1|-1|-1|-1|-1|01|01
01|01|01|01|01|01|01|01|01|01|-1|-1|-1|-1|-1|-1|-1|-1|-1|-1

[CollisionLayer]
-1|-1|-1|-1|-1|-1|-1|-1|-1|-1|-1|-1|-1|-1|-1|-1|-1|-1|-1|-1
-1|-1|-1|-1|-1|-1|-1|-1|-1|-1|-1|-1|-1|-1|-1|-1|-1|-1|-1|-1
-1|-1|-2|-1|-2|-1|-2|-1|-2|-2|-2|-1|-2|-2|-1|-2|-1|-1|-1|-1
-3|-1|-1|-1|-1|-1|-1|-1|-1|-2|-1|-1|-1|-1|-1|-2|-1|-1|-1|-1
-2|-2|-1|-1|-1|-1|-1|-1|-1|-2|-1|-1|-1|-1|-1|-2|-1|-1|-1|-1
-1|-2|-2|-1|-1|-1|-1|-1|-1|-1|-1|-1|-1|-1|-1|-2|-1|-1|-1|-1
-1|-1|-2|-2|-2|-2|-2|-2|-2|-2|-2|-2|-2|-2|-2|-2|-1|-1|-1|-1
-1|-1|-1|-1|-1|-1|-1|-1|-2|-1|-1|-1|-1|-1|-1|-1|-1|-1|-1|-1
-1|-2|-2|-2|-2|-2|-2|-2|-2|-1|-1|-1|-1|-1|-1|-1|-1|-1|-1|-1
-1|-2|-1|-1|-1|-1|-1|-1|-1|-1|-1|-1|-1|-1|-1|-1|-1|-1|-1|-1
-1|-2|-1|-1|-1|-1|-1|-1|-1|-1|-1|-1|-1|-1|-1|-1|-1|-1|-1|-1
-1|-2|-1|-1|-1|-1|-2|-2|-1|-1|-1|-1|-1|-1|-1|-1|-1|-1|-1|-1
-1|-2|-1|-1|-1|-1|-1|-1|-1|-1|-1|-1|-1|-1|-1|-1|-1|-1|-1|-1
-1|-2|-2|-2|-2|-1|-1|-1|-1|-1|-1|-1|-1|-1|-1|-1|-1|-1|-1|-1
-1|-2|-1|-1|-1|-1|-1|-1|-1|-1|-1|-1|-1|-1|-1|-1|-1|-1|-1|-1
-1|-2|-1|-1|-1|-1|-1|-1|-2|-1|-1|-1|-1|-1|-1|-1|-1|-1|-1|-1
-2|-2|-1|-1|-2|-2|-2|-2|-2|-2|-1|-1|-1|-1|-1|-1|-1|-1|-1|-1
-1|-1|-1|-1|-1|-1|-1|-1|-1|-1|-1|-1|-1|-1|-1|-1|-1|-1|-1|-1
-1|-1|-1|-1|-1|-1|-1|-1|-1|-1|-1|-1|-1|-1|-1|-1|-1|-1|-1|-1
-2|-2|-2|-2|-2|-2|-2|-2|-1|-1|-1|-1|-1|-1|-1|-1|-1|-1|-1|-1
-1|-1|-1|-1|-1|-1|-1|-1|-1|-1|-1|-1|-1|-1|-1|-1|-1|-1|-1|-1
-1|-1|-1|-1|-1|-1|-1|-1|-1|-1|-1|-1|-1|-1|-1|-1|-1|-1|-1|-1
-1|-1|-2|-2|-2|-2|-2|-2|-2|-2|-1|-1|-1|-1|-1|-1|-1|-1|-1|-1
-1|-1|-1|-1|-1|-1|-1|-1|-1|-1|-1|-1|-1|-1|-1|-1|-1|-1|-1|-1
-1|-1|-1|-1|-1|-1|-1|-1|-1|-1|-1|-1|-1|-1|-1|-1|-1|-1|-1|-1
-2|-2|-2|-2|-2|-2|-2|-2|-1|-1|-1|-1|-1|-1|-1|-1|-1|-1|-1|-1
-1|-1|-1|-1|-1|-1|-1|-1|-1|-1|-1|-1|-1|-1|-1|-1|-1|-1|-1|-1
-1|-1|-1|-1|-1|-1|-1|-1|-1|-1|-1|-1|-1|-1|-1|-1|-1|-1|-1|-1
-1|-1|-2|-2|-2|-2|-2|-2|-2|-2|-1|-1|-1|-1|-1|-1|-1|-1|-1|-1
-1|-1|-1|-1|-1|-1|-1|-1|-1|-1|-1|-1|-1|-1|-1|-1|-1|-1|-1|-1
-2|-2|-2|-2|-2|-2|-2|-2|-2|-1|-1|-1|-1|-1|-1|-1|-1|-1|-1|-1
-1|-1|-1|-1|-1|-1|-1|-1|-1|-1|-1|-1|-1|-1|-1|-1|-1|-1|-1|-1
-1|-2|-2|-2|-2|-2|-2|-2|-2|-2|-1|-1|-1|-1|-1|-1|-1|-1|-1|-1
-1|-1|-1|-1|-1|-1|-1|-1|-1|-2|-1|-1|-1|-1|-1|-1|-1|-1|-1|-1
-2|-2|-2|-2|-2|-1|-1|-1|-1|-1|-1|-1|-1|-1|-1|-1|-1|-1|-1|-1
-1|-1|-1|-1|-1|-1|-1|-2|-1|-1|-1|-1|-1|-1|-1|-1|-1|-1|-1|-1
-2|-2|-2|-2|-2|-2|-2|-2|-1|-1|-1|-1|-1|-1|-1|-1|-1|-1|-1|-1
-1|-1|-1|-1|-1|-1|-1|-1|-1|-1|-1|-1|-1|-1|-1|-1|-1|-1|-1|-1
-1|-2|-2|-2|-2|-2|-2|-2|-2|-2|-1|-1|-1|-1|-1|-1|-1|-1|-1|-1
-1|-2|-1|-1|-1|-1|-1|-1|-1|-1|-1|-1|-1|-1|-1|-1|-1|-1|-1|-1
-1|-2|-1|-1|-1|-1|-1|-1|-1|-1|-1|-1|-1|-1|-1|-1|-1|-1|-1|-1
-1|-2|-1|-1|-1|-1|-1|-1|-1|-1|-1|-1|-1|-1|-1|-1|-1|-1|-1|-1
-1|-2|-1|-2|-1|-1|-1|-1|-1|-1|-1|-1|-1|-1|-1|-1|-1|-1|-1|-1
-1|-1|-1|-2|-1|-1|-1|-1|-1|-1|-1|-1|-1|-1|-1|-1|-1|-1|-1|-1
-2|-2|-2|-2|-1|-1|-1|-1|-1|-1|-1|-1|-1|-1|-1|-1|-1|-1|-1|-1
-1|-2|-1|-2|-1|-1|-1|-1|-1|-1|-1|-1|-1|-1|-1|-1|-1|-1|-1|-1
00|-2|-1|-2|-1|-1|-1|-1|-1|-1|-1|-1|-1|-1|-1|-1|-1|-1|-1|-1
-1|-2|-2|-2|-1|-1|-1|-1|-1|-1|-1|-1|-1|-1|-1|-1|-1|-1|-1|-1
-1|-1|-1|-1|-1|-1|-1|-1|-1|-1|-1|-1|-1|-1|-1|-1|-1|-1|-1|-1
-2|-2|-2|-2|-2|-2|-2|-2|-2|-2|-1|-1|-1|-1|-1|-1|-1|-1|-1|-1
