[Type]
Dungeon

[Demensions]
20x50

[TileDemensions]
64x64

[Textures]
Background\Dirt 64 64
Background\Road 64 64
Background\Water 64 64
Dungeon\Fin 64 64
Dungeon\Start 64 64
Dungeon\Tree\Bark1 64 64
Dungeon\Tree\Bark2 64 64
Dungeon\Tree\Bark3 64 64
Inside\Furni\Book1 128 64
Inside\Floors\Tile_Grey 64 64
Inside\Floors\Wood 64 64
Inside\Floors\Tile_Blue 64 64
Inside\Floors\Tile_Green 64 64
Inside\Floors\Tile_Orange 64 64
Inside\Floors\Tile_Purple 64 64
Inside\Floors\Tile_Red 64 64

[Entrances]
TileMaps\D4End.map

[Enemies]
<Boss>
Thwomp 
Moving 104 138 1 100 None
Attacking 104 138 1 100 None
Stunned 104 138 1 100 None
Hurt 104 138 2 100 None

[TileLayer]
00|00|00|00|00|00|00|00|00|00|00|00|00|00|00|00|00|00|00|00
00|00|00|00|00|00|00|00|00|00|00|00|00|00|00|00|00|00|00|00
00|00|00|00|00|00|00|00|00|00|00|00|00|00|00|00|00|00|00|00
00|00|00|00|00|00|00|00|00|00|00|00|00|00|00|00|00|00|00|00
00|00|00|00|00|00|00|00|00|00|00|00|00|00|00|00|00|00|00|00
00|00|00|00|00|00|00|00|00|00|00|00|00|00|00|00|00|00|00|00
00|00|00|00|00|00|00|00|00|00|00|00|00|00|00|00|00|00|00|00
09|09|09|09|09|09|09|09|09|09|09|09|09|09|09|09|09|09|09|09
09|09|09|09|09|09|09|09|09|09|09|09|09|09|09|09|09|09|09|09
09|09|09|09|09|09|09|09|09|09|09|09|09|09|09|09|09|09|09|09
09|09|09|09|09|09|09|09|09|09|09|09|09|09|09|09|09|09|09|09
09|09|09|09|09|09|09|09|09|09|09|09|09|09|09|09|09|09|09|09
09|09|09|09|09|09|09|09|09|09|09|09|09|09|09|09|09|09|09|09
09|09|09|09|09|09|09|09|09|09|09|09|09|09|09|09|09|09|09|09
09|09|09|09|09|09|09|09|09|09|09|09|09|09|09|09|09|09|09|09
09|09|09|09|09|09|09|09|09|09|09|09|09|09|09|09|09|09|09|09
09|09|09|09|09|09|09|09|09|09|09|09|09|09|09|09|09|09|09|09
05|05|06|06|06|06|06|06|06|06|06|06|06|06|06|06|06|06|05|05
05|05|06|06|06|06|06|06|06|06|06|06|06|06|06|06|06|06|05|05
05|05|06|06|06|06|06|06|06|06|06|06|06|06|06|06|06|06|05|05
05|05|06|06|06|06|06|06|06|06|06|06|06|06|06|06|06|06|05|05
05|05|06|06|06|06|06|06|06|06|06|06|06|06|06|06|06|06|05|05
05|05|06|06|06|06|06|06|06|06|06|06|06|06|06|06|06|06|05|05
05|05|06|06|06|06|06|06|06|06|06|06|06|06|06|06|06|06|05|05
05|05|06|06|06|06|06|06|06|06|06|06|06|06|06|06|06|06|05|05
05|05|06|06|06|06|06|06|06|06|06|06|06|06|06|06|06|06|05|05
05|05|06|06|06|06|06|06|06|06|06|06|06|06|06|06|06|06|05|05
05|05|06|06|06|06|06|06|06|06|06|06|06|06|06|06|06|06|05|05
05|05|06|06|06|06|06|06|06|06|06|06|06|06|06|06|06|06|05|05
02|02|02|02|02|02|02|02|02|02|02|02|02|02|02|02|02|02|02|02
02|02|02|02|02|02|02|02|02|02|02|02|02|02|02|02|02|02|02|02
02|02|02|02|02|02|02|02|02|02|02|02|02|02|02|02|02|02|02|02
02|02|02|02|02|02|02|02|02|02|02|02|02|02|02|02|02|02|02|02
02|02|02|02|02|02|02|02|02|02|02|02|02|02|02|02|02|02|02|02
02|02|02|02|02|02|02|02|02|02|02|02|02|02|02|02|02|02|02|02
02|02|02|02|02|02|02|02|02|02|02|02|02|02|02|02|02|02|02|02
02|02|02|02|02|02|02|02|02|02|02|02|02|02|02|02|02|02|02|02
02|02|02|02|02|02|02|02|02|02|02|02|02|02|02|02|02|02|02|02
02|09|09|09|09|09|09|09|09|09|09|09|09|09|09|09|09|09|09|09
02|09|09|09|09|15|14|13|12|11|11|11|11|11|12|13|14|15|09|09
02|09|09|09|09|14|14|13|12|11|11|11|11|11|12|13|14|14|09|09
02|09|09|09|09|13|13|13|12|11|11|11|11|11|12|13|13|13|09|09
02|09|02|09|09|12|12|12|12|11|11|11|11|11|12|12|12|12|09|09
02|02|02|09|09|11|11|11|11|11|11|11|11|11|11|11|11|11|09|09
09|09|09|09|09|11|11|11|11|11|11|11|11|11|11|11|11|11|09|09
09|09|09|09|09|12|12|12|12|11|11|11|11|11|12|12|12|12|09|09
09|09|09|09|09|13|13|13|12|11|11|11|11|11|12|13|13|13|09|09
09|09|09|09|09|14|14|13|12|11|11|11|11|11|12|13|14|14|09|09
09|09|09|09|09|15|14|13|12|11|11|11|11|11|12|13|14|15|09|09
09|09|09|09|09|09|09|09|09|09|09|09|09|09|09|09|09|09|09|09

[TileLayer]
-1|-1|-1|-1|-1|-1|-1|-1|-1|-1|-1|-1|-1|-1|-1|-1|-1|-1|01|01
-1|-1|-1|-1|-1|-1|-1|-1|-1|-1|-1|-1|-1|-1|-1|-1|-1|-1|01|01
-1|-1|01|-1|01|-1|01|-1|01|01|01|-1|01|01|-1|01|-1|-1|01|01
-1|-1|-1|-1|-1|-1|-1|-1|-1|01|-1|-1|-1|-1|-1|01|-1|-1|01|01
01|01|-1|-1|-1|-1|-1|-1|-1|01|-1|-1|-1|-1|-1|01|-1|-1|01|01
01|01|01|-1|00|-1|-1|-1|-1|-1|-1|-1|-1|-1|-1|01|-1|-1|01|01
01|01|01|01|01|01|01|01|01|01|01|01|01|01|01|01|-1|-1|01|01
01|01|01|01|01|01|01|01|01|-1|-1|-1|-1|-1|-1|-1|-1|-1|01|01
01|01|01|01|01|01|01|01|01|-1|-1|-1|-1|-1|-1|-1|-1|-1|01|01
01|01|-1|-1|-1|-1|-1|-1|-1|-1|10|10|10|10|10|10|10|10|01|01
01|01|-1|10|10|10|10|10|10|10|10|-1|-1|-1|-1|-1|-1|-1|01|01
01|01|-1|-1|-1|-1|-1|-1|-1|-1|-1|-1|-1|-1|-1|-1|-1|-1|01|01
01|01|10|10|10|10|10|10|10|10|10|10|10|10|10|10|10|-1|01|01
01|01|-1|-1|-1|-1|-1|-1|-1|-1|-1|-1|-1|-1|-1|-1|-1|-1|01|01
01|01|-1|10|10|10|10|10|10|10|10|10|10|10|10|10|10|10|01|01
01|01|-1|-1|-1|-1|-1|-1|-1|-1|-1|-1|-1|-1|-1|-1|-1|-1|01|01
01|01|10|10|10|10|10|10|10|10|10|10|10|10|10|10|-1|-1|01|01
-1|-1|-1|-1|-1|-1|-1|-1|-1|-1|-1|-1|-1|-1|-1|07|-1|-1|-1|-1
-1|-1|-1|-1|-1|-1|-1|-1|-1|-1|-1|-1|-1|-1|-1|07|-1|-1|-1|-1
-1|-1|07|07|-1|-1|07|-1|-1|-1|-1|-1|-1|-1|-1|07|07|07|-1|-1
-1|-1|07|-1|07|-1|-1|-1|07|-1|-1|-1|-1|-1|-1|-1|-1|-1|-1|-1
-1|-1|07|-1|-1|-1|-1|-1|-1|-1|07|-1|-1|07|07|07|07|07|07|-1
-1|-1|07|-1|-1|-1|-1|-1|-1|-1|-1|-1|-1|-1|-1|-1|-1|-1|-1|-1
-1|-1|07|-1|-1|-1|-1|-1|-1|-1|-1|-1|-1|-1|-1|-1|-1|-1|-1|07
-1|-1|07|07|-1|07|-1|07|-1|-1|-1|-1|-1|-1|-1|-1|-1|-1|07|07
-1|-1|07|-1|-1|-1|-1|-1|-1|07|-1|07|07|-1|-1|-1|-1|07|07|07
-1|-1|07|-1|-1|-1|-1|-1|-1|-1|-1|-1|-1|-1|-1|-1|07|07|07|07
-1|-1|07|-1|-1|-1|-1|-1|-1|-1|-1|-1|-1|-1|-1|07|07|07|07|07
-1|-1|07|07|07|07|07|07|07|07|07|07|07|07|07|07|07|07|07|07
-1|-1|-1|-1|-1|-1|-1|-1|-1|-1|-1|-1|-1|-1|-1|-1|-1|-1|01|01
01|01|01|01|01|01|01|01|01|01|01|01|01|01|01|01|-1|-1|01|01
-1|-1|-1|-1|-1|-1|-1|-1|-1|-1|-1|-1|-1|-1|-1|-1|-1|-1|01|01
-1|01|01|01|01|01|01|01|01|01|-1|-1|-1|-1|-1|-1|-1|-1|01|01
-1|-1|-1|-1|-1|-1|-1|-1|-1|01|01|01|01|01|01|01|01|01|01|01
01|01|01|01|01|-1|-1|-1|-1|-1|-1|-1|-1|-1|-1|-1|-1|-1|01|01
-1|-1|-1|-1|-1|-1|-1|01|-1|-1|-1|-1|-1|-1|-1|-1|-1|-1|01|01
01|01|01|01|01|01|01|01|01|01|01|01|01|01|01|01|01|-1|01|01
-1|-1|-1|-1|-1|-1|-1|-1|-1|-1|-1|-1|-1|-1|-1|-1|-1|-1|01|01
-1|01|01|01|01|01|01|01|01|01|01|01|01|01|01|01|01|01|01|01
-1|01|-1|-1|01|-1|-1|-1|-1|-1|-1|-1|-1|-1|-1|-1|-1|-1|01|01
-1|01|-1|-1|01|-1|-1|-1|-1|-1|-1|-1|-1|-1|-1|-1|-1|-1|01|01
-1|01|-1|-1|-1|-1|-1|-1|-1|-1|-1|-1|-1|-1|-1|-1|-1|-1|01|01
-1|01|-1|01|01|-1|-1|-1|-1|-1|-1|-1|-1|-1|-1|-1|-1|-1|01|01
-1|-1|-1|01|01|-1|-1|-1|-1|-1|-1|-1|-1|-1|-1|-1|-1|-1|01|01
01|01|01|01|01|-1|-1|-1|-1|-1|-1|-1|-1|-1|-1|-1|-1|-1|01|01
01|01|01|01|01|-1|-1|-1|-1|-1|-1|-1|-1|-1|-1|-1|-1|-1|01|01
01|01|01|01|01|-1|-1|-1|-1|-1|-1|-1|-1|-1|-1|-1|-1|-1|01|01
01|01|01|01|01|-1|-1|-1|-1|-1|-1|-1|-1|-1|-1|-1|-1|-1|01|01
01|01|01|01|01|-1|-1|-1|-1|-1|-1|-1|-1|-1|-1|-1|-1|-1|03|01
01|01|01|01|01|01|01|01|01|01|01|01|01|01|01|01|01|01|01|01

[CollisionLayer]
-1|-1|-1|-1|-1|-1|-1|-1|-1|-1|-1|-1|-1|-1|-1|-1|-1|-1|-2|-1
-1|-1|-1|-1|-1|-1|-1|-1|-1|-1|-1|-1|-1|-1|-1|-1|-1|-1|-2|-1
-1|-1|-2|-1|-2|-1|-2|-1|-2|-2|-2|-1|-2|-2|-1|-2|-1|-1|-2|-1
-1|-3|-1|-1|-1|-1|-1|-1|-1|-2|-1|-1|-1|-1|-1|-2|-1|-1|-2|-1
-2|-2|-1|-1|-1|-1|-1|-1|-1|-2|-1|-1|-1|-1|-1|-2|-1|-1|-2|-1
-1|-2|-2|-1|-1|-1|-1|-1|-1|-1|-1|-1|-1|-1|-1|-2|-1|-1|-2|-1
-1|-1|-2|-2|-2|-2|-2|-2|-2|-2|-2|-2|-2|-2|-2|-2|-1|-1|-2|-1
-1|-1|-1|-1|-1|-1|-1|-1|-2|-1|-1|-1|-1|-1|-1|-1|-1|-1|-2|-1
-1|-2|-2|-2|-2|-2|-2|-2|-2|-1|-1|-1|-1|-1|-1|-1|-1|-1|-2|-1
-1|-2|-1|-1|-1|-1|-1|-1|-1|-1|-2|-2|-2|-2|-2|-2|-2|-2|-2|-1
-1|-2|-1|-2|-2|-2|-2|-2|-2|-2|-2|-1|-1|-1|-1|-1|-1|-1|-2|-1
-1|-2|-1|-1|-1|-1|-1|-1|-1|-1|-1|-1|-1|-1|-1|-1|-1|-1|-2|-1
-1|-2|-2|-2|-2|-2|-2|-2|-2|-2|-2|-2|-2|-2|-2|-2|-2|-1|-2|-1
-1|-2|-1|-1|-1|-1|-1|-1|-1|-1|-1|-1|-1|-1|-1|-1|-1|-1|-2|-1
-1|-2|-1|-2|-2|-2|-2|-2|-2|-2|-2|-2|-2|-2|-2|-2|-2|-2|-2|-1
-1|-2|-1|-1|-1|-1|-1|-1|-1|-1|-1|-1|-1|-1|-1|-1|-1|-1|-2|-1
-2|-2|-2|-2|-2|-2|-2|-2|-2|-2|-2|-2|-2|-2|-2|-2|-1|-1|-2|-2
-1|-1|-1|-1|-1|-1|-1|-1|-1|-1|-1|-1|-1|-1|-1|-2|-1|-1|-1|-1
-1|-1|-1|-1|-1|-1|-1|-1|-1|-1|-1|-1|-1|-1|-1|-2|-1|-1|-1|-1
-1|-1|-2|-2|-1|-1|-2|-1|-1|-1|-1|-1|-1|-1|-1|-2|-2|-2|-1|-1
-1|-1|-2|-1|-2|-1|-1|-1|-2|-1|-1|-1|-1|-1|-1|-1|-1|-1|-1|-1
-1|-1|-2|-1|-1|-1|-1|-1|-1|-1|-2|-1|-1|-2|-2|-2|-2|-2|-2|-1
-1|-1|-2|-1|-1|-1|-1|-1|-1|-1|-1|-1|-1|-1|-1|-1|-1|-1|-1|-1
-1|-1|-2|-1|-1|-1|-1|-1|-1|-1|-1|-1|-1|-1|-1|-1|-1|-1|-1|-2
-1|-1|-2|-2|-1|-2|-1|-2|-1|-1|-1|-1|-1|-1|-1|-1|-1|-1|-2|-2
-1|-1|-2|-1|-1|-1|-1|-1|-1|-2|-1|-2|-2|-1|-1|-1|-1|-2|-2|-1
-1|-1|-2|-1|-1|-1|-1|-1|-1|-1|-1|-1|-1|-1|-1|-1|-2|-2|-1|-1
-1|-1|-2|-1|-1|-1|-1|-1|-1|-1|-1|-1|-1|-1|-1|-2|-2|-1|-1|-1
-1|-1|-2|-2|-2|-2|-2|-2|-2|-2|-2|-2|-2|-2|-2|-2|-2|-2|-2|-1
-1|-1|-1|-1|-1|-1|-1|-1|-1|-1|-1|-1|-1|-1|-1|-1|-1|-1|-2|-1
-2|-2|-2|-2|-2|-2|-2|-2|-2|-2|-2|-2|-2|-2|-2|-2|-1|-1|-2|-1
-1|-1|-1|-1|-1|-1|-1|-1|-1|-1|-1|-1|-1|-1|-1|-1|-1|-1|-2|-1
-1|-2|-2|-2|-2|-2|-2|-2|-2|-2|-1|-1|-1|-1|-1|-1|-1|-1|-2|-1
-1|-1|-1|-1|-1|-1|-1|-1|-1|-2|-2|-2|-2|-2|-2|-2|-2|-2|-2|-1
-2|-2|-2|-2|-2|-1|-1|-1|-1|-1|-1|-1|-1|-1|-1|-1|-1|-1|-2|-1
-1|-1|-1|-1|-1|-1|-1|-2|-1|-1|-1|-1|-1|-1|-1|-1|-1|-1|-2|-1
-2|-2|-2|-2|-2|-2|-2|-2|-2|-2|-2|-2|-2|-2|-2|-2|-2|-1|-2|-1
-1|-1|-1|-1|-1|-1|-1|-1|-1|-1|-1|-1|-1|-1|-1|-1|-1|-1|-2|-1
-1|-2|-2|-2|-2|-2|-2|-2|-2|-2|-2|-2|-2|-2|-2|-2|-2|-2|-2|-1
-1|-2|-1|-1|-2|-1|-1|-1|-1|-1|-1|-1|-1|-1|-1|-1|-1|-1|-2|-1
-1|-2|-1|-1|-2|-1|-1|-1|-1|-1|-1|-1|-1|-1|-1|-1|-1|-1|-2|-1
-1|-2|-1|-1|-1|-1|-1|-1|-1|-1|-1|-1|-1|-1|-1|-1|-1|-1|-2|-1
-1|-2|-1|-2|-2|-1|-1|-1|-1|-1|-1|-1|-1|-1|-1|-1|-1|-1|-2|-1
-1|-1|-1|-2|-2|-1|-1|-1|-1|-1|-1|-1|-1|-1|-1|-1|-1|-1|-2|-1
-2|-2|-2|-2|-2|-1|-1|-1|-1|-1|-1|-1|-1|-1|-1|-1|-1|-1|-2|-1
-1|-1|-1|-1|-2|-1|-1|-1|-1|-1|-1|-1|-1|-1|-1|-1|-1|-1|-2|-1
-1|-1|-1|-1|-2|-1|-1|-1|-1|-1|-1|-1|-1|-1|-1|-1|-1|-1|-2|-1
-1|-1|-1|-1|-2|-1|-1|-1|-1|-1|-1|-1|-1|-1|-1|-1|-1|-1|-2|-2
-1|-1|-1|-1|-2|-1|-1|-1|-1|-1|-1|-1|-1|-1|-1|-1|-1|-1|00|-2
-2|-2|-2|-2|-2|-2|-2|-2|-2|-2|-2|-2|-2|-2|-2|-2|-2|-2|-2|-2

[EnemyLayer]
-1|-1|-1|-1|-1|-1|-1|-1|-1|-1|-1|-1|-1|-1|-1|-1|-1|-1|-1|-1
-1|-1|-1|-1|-1|-1|-1|-1|-1|-1|-1|-1|-1|-1|-1|-1|-1|-1|-1|-1
-1|-1|-1|-1|-1|-1|-1|-1|-1|-1|-1|-1|-1|-1|-1|-1|-1|-1|-1|-1
-1|-1|-1|-1|-1|-1|-1|-1|-1|-1|-1|-1|-1|-1|-1|-1|-1|-1|-1|-1
-1|-1|-1|-1|-1|-1|-1|-1|-1|-1|-1|-1|-1|-1|-1|-1|-1|-1|-1|-1
-1|-1|-1|-1|-1|-1|-1|-1|-1|-1|-1|-1|-1|-1|-1|-1|-1|-1|-1|-1
-1|-1|-1|-1|-1|-1|-1|-1|-1|-1|-1|-1|-1|-1|-1|-1|-1|-1|-1|-1
-1|-1|-1|-1|-1|-1|-1|-1|-1|-1|-1|-1|-1|-1|-1|-1|-1|-1|-1|-1
-1|-1|-1|-1|-1|-1|-1|-1|-1|-1|-1|-1|-1|-1|-1|-1|-1|-1|-1|-1
-1|-1|-1|-1|-1|-1|-1|-1|-1|-1|-1|-1|-1|-1|-1|-1|-1|-1|-1|-1
-1|-1|-1|-1|-1|-1|-1|-1|-1|-1|-1|-1|-1|-1|-1|-1|-1|-1|-1|-1
-1|-1|-1|-1|-1|-1|-1|-1|-1|-1|-1|-1|-1|-1|-1|-1|-1|-1|-1|-1
-1|-1|-1|-1|-1|-1|-1|-1|-1|-1|-1|-1|-1|-1|-1|-1|-1|-1|-1|-1
-1|-1|-1|-1|-1|-1|-1|-1|-1|-1|-1|-1|-1|-1|-1|-1|-1|-1|-1|-1
-1|-1|-1|-1|-1|-1|-1|-1|-1|-1|-1|-1|-1|-1|-1|-1|-1|-1|-1|-1
-1|-1|-1|-1|-1|-1|-1|-1|-1|-1|-1|-1|-1|-1|-1|-1|-1|-1|-1|-1
-1|-1|-1|-1|-1|-1|-1|-1|-1|-1|-1|-1|-1|-1|-1|-1|-1|-1|-1|-1
-1|-1|-1|-1|-1|-1|-1|-1|-1|-1|-1|-1|-1|-1|-1|-1|-1|-1|-1|-1
-1|-1|-1|-1|-1|-1|-1|-1|-1|-1|-1|-1|-1|-1|-1|-1|-1|-1|-1|-1
-1|-1|-1|-1|-1|-1|-1|-1|-1|-1|-1|-1|-1|-1|-1|-1|-1|-1|-1|-1
-1|-1|-1|-1|-1|-1|-1|-1|-1|-1|-1|-1|-1|-1|-1|-1|-1|-1|-1|-1
-1|-1|-1|-1|-1|-1|-1|-1|-1|-1|-1|-1|-1|-1|-1|-1|-1|-1|-1|-1
-1|-1|-1|-1|-1|-1|-1|-1|-1|-1|-1|-1|-1|-1|-1|-1|-1|-1|-1|-1
-1|-1|-1|-1|-1|-1|-1|-1|-1|-1|-1|-1|-1|-1|-1|-1|-1|-1|-1|-1
-1|-1|-1|-1|-1|-1|-1|-1|-1|-1|-1|-1|-1|-1|-1|-1|-1|-1|-1|-1
-1|-1|-1|-1|-1|-1|-1|-1|-1|-1|-1|-1|-1|-1|-1|-1|-1|-1|-1|-1
-1|-1|-1|-1|-1|-1|-1|-1|-1|-1|-1|-1|-1|-1|-1|-1|-1|-1|-1|-1
-1|-1|-1|-1|-1|-1|-1|-1|-1|-1|-1|-1|-1|-1|-1|-1|-1|-1|-1|-1
-1|-1|-1|-1|-1|-1|-1|-1|-1|-1|-1|-1|-1|-1|-1|-1|-1|-1|-1|-1
-1|-1|-1|-1|-1|-1|-1|-1|-1|-1|-1|-1|-1|-1|-1|-1|-1|-1|-1|-1
-1|-1|-1|-1|-1|-1|-1|-1|-1|-1|-1|-1|-1|-1|-1|-1|-1|-1|-1|-1
-1|-1|-1|-1|-1|-1|-1|-1|-1|-1|-1|-1|-1|-1|-1|-1|-1|-1|-1|-1
-1|-1|-1|-1|-1|-1|-1|-1|-1|-1|-1|-1|-1|-1|-1|-1|-1|-1|-1|-1
-1|-1|-1|-1|-1|-1|-1|-1|-1|-1|-1|-1|-1|-1|-1|-1|-1|-1|-1|-1
-1|-1|-1|-1|-1|-1|-1|-1|-1|-1|-1|-1|-1|-1|-1|-1|-1|-1|-1|-1
-1|-1|-1|-1|-1|-1|-1|-1|-1|-1|-1|-1|-1|-1|-1|-1|-1|-1|-1|-1
-1|-1|-1|-1|-1|-1|-1|-1|-1|-1|-1|-1|-1|-1|-1|-1|-1|-1|-1|-1
-1|-1|-1|-1|-1|-1|-1|-1|-1|-1|-1|-1|-1|-1|-1|-1|-1|-1|-1|-1
-1|-1|-1|-1|-1|-1|-1|-1|-1|-1|-1|-1|-1|-1|-1|-1|-1|-1|-1|-1
-1|-1|-1|-1|-1|-1|-1|-1|-1|-1|-1|-1|-1|-1|-1|-1|-1|-1|-1|-1
-1|-1|-1|-1|-1|-1|-1|-1|-1|-1|-1|-1|-1|-1|-1|-1|-1|-1|-1|-1
-1|-1|-1|-1|-1|-1|-1|-1|-1|-1|-1|-1|-1|-1|-1|-1|-1|-1|-1|-1
-1|-1|-1|-1|-1|-1|-1|-1|-1|-1|-1|-1|-1|-1|-1|-1|-1|-1|-1|-1
-1|-1|-1|-1|-1|-1|-1|-1|-1|-1|-1|-1|-1|-1|00|-1|-1|-1|-1|-1
-1|-1|-1|-1|-1|-1|-1|-1|-1|-1|-1|-1|-1|-1|-1|-1|-1|-1|-1|-1
-1|-1|-1|-1|-1|-1|-1|-1|-1|-1|-1|-1|-1|-1|-1|-1|-1|-1|-1|-1
-1|-1|-1|-1|-1|-1|-1|-1|-1|-1|-1|-2|-1|-1|-1|-1|-1|-1|-1|-1
-1|-1|-1|-1|-1|-1|-1|-1|-1|-1|-1|-1|-1|-1|-1|-1|-1|-1|-1|-1
-1|-1|-1|-1|-1|-1|-1|-1|-1|-1|-1|-1|-1|-1|-1|-1|-1|-1|-1|-1
-1|-1|-1|-1|-1|-1|-1|-1|-1|-1|-1|-1|-1|-1|-1|-1|-1|-1|-1|-1
