[Type]
OverWorld

[Demensions]
10x10

[TileDemensions]
64x64

[Textures]
Inside\Floors\Gym 640 380
Inside\Floors\Tile_Orange 64 64
Inside\Floors\Tile_Grey 64 64
Inside\Furni\door 64 64

[Entrances]
TileMaps\overworld.map
TileMaps\D2Basement.map

[NPCs]
Hugh Left 23 50
Anna Centre 23 50
Josh Right 23 50

[TileLayer]
01|01|01|01|01|01|01|01|01|01
01|01|01|01|01|01|01|01|01|01
00|-1|-1|-1|-1|-1|-1|-1|-1|-1
-1|-1|-1|-1|-1|-1|-1|-1|-1|-1
-1|-1|-1|-1|-1|-1|-1|-1|-1|-1
-1|-1|-1|-1|-1|-1|-1|-1|-1|-1
-1|-1|-1|-1|-1|-1|-1|-1|-1|-1
-1|-1|-1|-1|-1|-1|-1|-1|-1|-1
01|01|01|01|01|01|01|01|01|01
01|01|01|01|02|02|01|01|01|01

[TileLayer]
-1|-1|-1|-1|-1|-1|-1|-1|-1|03
-1|-1|-1|-1|-1|-1|-1|-1|-1|-1
-1|-1|-1|-1|-1|-1|-1|-1|-1|-1
-1|-1|-1|-1|-1|-1|-1|-1|-1|-1
-1|-1|-1|-1|-1|-1|-1|-1|-1|-1
-1|-1|-1|-1|-1|-1|-1|-1|-1|-1
-1|-1|-1|-1|-1|-1|-1|-1|-1|-1
-1|-1|-1|-1|-1|-1|-1|-1|-1|-1
-1|-1|-1|-1|-1|-1|-1|-1|-1|-1
-1|-1|-1|-1|-1|-1|-1|-1|-1|-1

[CollisionLayer]
-1|-1|-1|-1|-1|-1|-1|-1|-1|01
-1|-1|-1|-1|-1|-1|-1|-1|-1|-1
-1|-1|-1|-1|-1|-1|-1|-1|-1|-1
-1|-1|-1|-1|-1|-1|-1|-1|-1|-1
-1|-1|-1|-1|-1|-1|-1|-1|-1|-1
-1|-1|-1|-1|-1|-1|-1|-1|-1|-1
-1|-1|-1|-1|-1|-1|-1|-1|-1|-1
-1|-1|-1|-1|-1|-1|-1|-1|-1|-1
-1|-1|-1|-1|-1|-3|-1|-1|-1|-1
-1|-1|-1|-1|00|00|-1|-1|-1|-1

[NPCLayer]
-1|-1|-1|-1|-1|-1|-1|-1|02|-1
-1|-1|-1|-1|-1|-1|-1|-1|-1|-1
-1|-1|-1|-1|-1|-1|-1|-1|-1|-1
-1|-1|-1|-1|-1|-1|-1|-1|-1|-1
-1|-1|-1|-1|-1|01|-1|-1|-1|-1
-1|-1|-1|-1|-1|-1|-1|-1|-1|-1
-1|-1|-1|-1|-1|-1|-1|-1|-1|-1
-1|-1|-1|-1|-1|-1|-1|-1|-1|-1
-1|-1|-1|00|-1|-1|-1|-1|-1|-1
-1|-1|-1|-1|-1|-1|-1|-1|-1|-1
