[Demensions]
7x7

[TileDemensions]
64x64

[Textures]
Inside\Furni\Desk 64 64
Inside\Floors\Wood 64 64
Inside\Floors\Tile_Green 64 64
Inside\Floors\Tile_Grey 64 64
Inside\Books\Book1 128 64

[TileLayer]
01|01|01|01|01|01|01
01|01|01|01|01|01|01
01|01|01|01|01|01|01
01|01|01|01|01|01|01
01|01|01|01|01|01|01
01|01|02|02|02|01|01
01|01|02|03|02|01|01

[TileLayer]
04|-1|-1|-1|-1|04|-1
-1|-1|-1|00|-1|-1|-1
04|-1|-1|-1|-1|04|-1
-1|-1|-1|00|-1|-1|-1
04|-1|-1|-1|-1|04|-1
-1|-1|-1|-1|-1|-1|-1
00|-1|-1|-1|-1|-1|00

[CollisionLayer]
-2|-2|-1|-1|-1|-2|-2
-1|-1|-1|-2|-1|-1|-1
-2|-2|-1|-1|-1|-2|-2
-1|-1|-1|-2|-1|-1|-1
-2|-2|-1|-1|-1|-2|-2
-1|-1|-1|-1|-1|-1|-1
-2|-1|-1|-1|-1|-1|-2
