[Demensions]
30x30

[TileDemensions]
64x64

[Textures]
Background\Grass 64 64
Background\Tree1 64 64
Background\Tree2 64 64
Background\Tree3 64 64
Background\Road 64 64
Background\Water 64 64
Background\Sand\SandDown 64 64
Background\Sand\SandUp 64 64
Background\Sand\SandLeft 64 64
Background\Sand\SandRight 64 64
Background\Sand\SandUpLeft 64 64
Background\Sand\SandUpRight 64 64
Background\Sand\SandDownLeft 64 64
Background\Sand\SandDownRight 64 64
Background\Sand\SandSquareTL 64 64
Background\Sand\SandSquareTR 64 64
Background\Sand\SandSquareBL 64 64
Background\Sand\SandSquareBR 64 64
Buildings\house1 256 128
Buildings\Gym 256 256
Buildings\Mart 128 128
Buildings\PC 128 128
Buildings\House2 192 192
Buildings\House3 192 192
Buildings\House4 192 192
Buildings\House5 256 192
Buildings\House6 256 192
Background\Gate 128 64
Background\Statue 128 64

[Entrances]
TileMaps\house1.map
TileMaps\PC.map

[TileLayer]
00|00|00|00|00|00|00|00|00|00|00|00|00|00|00|00|00|00|00|00|00|00|00|09|05|05|08|00|00|00
00|00|00|00|00|00|00|00|00|00|00|00|00|00|00|00|00|00|00|00|00|00|00|09|05|05|08|00|00|00
00|00|00|00|00|00|00|00|00|00|00|00|00|00|00|00|00|00|00|00|00|00|17|13|05|05|12|16|00|00
00|00|04|04|04|04|04|04|04|04|04|04|04|04|04|04|04|04|04|04|04|17|13|05|05|05|05|08|00|00
00|00|04|04|04|04|04|04|04|04|04|04|04|04|04|04|04|04|04|04|04|09|05|05|05|05|05|08|00|00
00|00|04|00|00|00|00|00|00|00|00|00|00|00|04|04|00|00|00|00|04|09|05|05|05|05|05|08|00|00
00|00|04|00|00|00|00|00|00|00|00|00|00|00|04|04|00|00|00|00|04|15|11|05|05|05|10|14|00|00
00|00|04|00|00|00|00|00|00|00|00|00|00|00|04|04|00|00|00|00|04|00|15|07|07|07|14|00|00|00
00|00|04|00|00|00|00|00|04|04|00|00|00|00|04|04|00|00|00|00|04|00|00|00|00|00|00|00|00|00
00|00|04|04|04|04|04|04|04|04|04|04|04|04|04|04|04|04|04|04|04|04|04|04|04|04|00|00|00|00
00|00|04|04|04|04|04|04|04|04|04|04|04|04|04|04|04|04|04|04|04|04|04|04|04|04|00|00|00|00
00|00|04|00|00|00|04|00|00|00|00|04|04|04|04|04|04|04|04|00|00|00|00|00|04|04|00|00|00|00
00|00|04|00|00|00|04|00|00|00|00|04|04|04|00|00|04|04|04|00|00|00|00|00|04|04|00|00|00|00
00|00|04|00|00|00|04|00|00|00|00|04|04|04|00|00|04|04|04|04|04|04|04|04|04|04|00|00|00|00
00|00|04|04|04|04|04|00|00|00|00|04|04|04|04|04|04|04|04|00|00|00|00|00|04|04|00|00|00|00
00|00|04|04|04|04|04|00|00|00|00|04|04|04|04|04|04|04|04|00|00|00|00|00|04|04|00|00|00|00
00|00|04|04|04|04|04|00|00|00|00|04|04|04|04|04|04|04|04|00|00|00|00|00|04|04|00|00|00|00
00|00|04|04|04|04|04|00|00|00|00|00|00|00|04|04|00|00|00|00|00|00|00|00|04|04|00|00|00|00
00|00|04|04|04|04|04|00|00|00|00|00|00|00|04|04|00|00|00|00|00|00|00|00|04|04|00|00|00|00
00|00|04|04|04|04|04|00|00|00|00|00|00|00|04|04|00|00|00|00|00|00|04|04|04|04|00|00|00|00
00|00|04|04|04|04|04|00|00|00|00|00|00|00|04|04|00|00|00|00|00|00|04|04|04|04|00|00|00|00
00|00|04|04|04|04|04|04|04|04|04|04|04|04|04|04|04|04|04|04|04|04|04|04|04|04|00|00|00|00
00|00|04|04|04|04|04|04|04|04|04|04|04|04|04|04|04|04|04|04|04|04|04|04|00|00|00|00|00|00
00|00|04|00|00|00|00|00|00|00|00|00|00|00|04|04|00|00|00|00|00|00|04|04|00|00|00|00|00|00
00|00|04|00|00|00|00|00|00|00|00|00|00|00|04|04|00|00|00|00|00|00|04|04|00|00|00|00|00|00
00|00|04|00|00|00|00|00|00|00|00|00|00|00|04|04|00|00|00|00|00|00|04|04|00|00|00|00|00|00
00|00|04|00|00|00|00|00|00|00|00|00|00|00|04|04|00|00|00|00|00|00|04|04|00|00|00|00|00|00
00|00|04|04|04|04|04|04|04|04|04|04|04|04|04|04|04|04|04|04|04|04|04|04|00|00|00|00|00|00
00|00|00|00|00|00|00|00|00|00|00|00|00|00|04|04|00|00|00|00|00|00|00|00|00|00|00|00|00|00
00|00|00|00|00|00|00|00|00|00|00|00|00|00|04|04|00|00|00|00|00|00|00|00|00|00|00|00|00|00

[TileLayer]
01|02|01|03|01|02|01|24|-1|-1|02|01|25|-1|-1|-1|01|26|-1|-1|-1|01|02|03|-1|-1|03|01|03|01
02|-1|-1|-1|-1|-1|-1|-1|-1|-1|-1|-1|-1|-1|-1|-1|-1|-1|-1|-1|-1|-1|-1|-1|-1|-1|-1|-1|-1|03
03|-1|-1|-1|-1|-1|-1|-1|-1|-1|-1|-1|-1|-1|-1|-1|-1|-1|-1|-1|-1|-1|-1|-1|-1|-1|-1|-1|-1|01
01|-1|-1|-1|-1|-1|-1|-1|-1|-1|-1|-1|-1|-1|-1|-1|-1|-1|-1|-1|-1|-1|-1|-1|-1|-1|-1|-1|-1|02
02|-1|-1|-1|-1|-1|-1|-1|-1|-1|-1|-1|-1|-1|-1|-1|-1|-1|-1|-1|-1|-1|-1|-1|-1|-1|-1|-1|-1|01
03|-1|-1|-1|-1|-1|-1|-1|-1|-1|-1|-1|-1|-1|-1|-1|-1|-1|-1|-1|-1|-1|-1|-1|-1|-1|-1|-1|-1|03
02|-1|-1|-1|-1|02|-1|03|20|-1|-1|02|-1|-1|-1|-1|-1|02|-1|-1|-1|-1|-1|-1|-1|-1|-1|-1|-1|02
03|-1|-1|-1|03|-1|01|-1|-1|-1|-1|-1|01|-1|-1|-1|-1|-1|01|-1|-1|-1|-1|-1|-1|-1|-1|-1|-1|01
01|-1|-1|-1|-1|-1|-1|-1|-1|-1|-1|-1|-1|-1|-1|-1|-1|-1|-1|-1|-1|-1|-1|-1|-1|-1|-1|-1|-1|03
02|-1|-1|-1|-1|-1|-1|-1|-1|-1|-1|-1|-1|-1|-1|-1|-1|-1|-1|-1|-1|-1|-1|-1|-1|-1|-1|-1|-1|02
03|-1|-1|-1|-1|-1|-1|-1|-1|-1|-1|-1|-1|-1|-1|-1|-1|-1|-1|-1|-1|-1|-1|-1|-1|-1|-1|-1|-1|01
02|-1|-1|-1|-1|-1|-1|01|02|01|02|-1|-1|-1|-1|-1|-1|-1|-1|18|-1|-1|-1|01|-1|-1|-1|-1|-1|02
01|-1|-1|21|-1|02|-1|-1|-1|-1|03|-1|-1|-1|28|-1|-1|-1|-1|-1|-1|-1|-1|02|-1|-1|-1|-1|-1|03
03|-1|-1|-1|-1|03|-1|-1|-1|-1|01|-1|-1|-1|-1|-1|-1|-1|-1|-1|-1|-1|-1|-1|-1|-1|-1|-1|-1|02
02|-1|-1|-1|-1|-1|-1|-1|-1|-1|02|-1|-1|-1|-1|-1|-1|-1|-1|03|-1|-1|-1|-1|-1|-1|-1|-1|-1|01
03|-1|-1|-1|-1|-1|-1|-1|-1|-1|03|-1|-1|-1|-1|-1|-1|-1|-1|02|-1|01|-1|-1|-1|-1|-1|-1|-1|02
02|-1|-1|-1|-1|-1|-1|-1|-1|-1|01|-1|-1|-1|-1|-1|-1|-1|-1|01|-1|-1|-1|-1|-1|-1|-1|-1|-1|02
03|-1|-1|-1|-1|-1|-1|-1|-1|-1|02|03|01|02|-1|-1|02|03|02|03|-1|-1|01|-1|-1|-1|-1|-1|-1|01
01|-1|-1|-1|-1|-1|-1|-1|-1|-1|22|-1|-1|02|-1|-1|03|-1|-1|-1|-1|-1|-1|-1|-1|-1|-1|-1|-1|03
02|-1|-1|-1|-1|-1|-1|-1|-1|-1|-1|-1|-1|02|-1|-1|01|-1|03|-1|01|-1|-1|-1|-1|-1|-1|-1|-1|02
03|-1|-1|-1|-1|-1|-1|-1|-1|-1|-1|-1|-1|03|-1|-1|03|-1|-1|-1|-1|-1|-1|-1|-1|-1|-1|-1|-1|01
02|-1|-1|-1|-1|-1|-1|-1|-1|-1|-1|-1|-1|-1|-1|-1|-1|-1|-1|-1|-1|-1|-1|-1|-1|-1|-1|-1|-1|03
03|-1|-1|-1|-1|-1|-1|-1|-1|-1|-1|-1|-1|-1|-1|-1|-1|-1|-1|-1|-1|-1|-1|-1|-1|-1|-1|-1|-1|02
01|-1|-1|-1|-1|-1|-1|-1|-1|19|-1|-1|-1|01|-1|-1|03|-1|-1|-1|03|-1|-1|-1|-1|-1|-1|-1|-1|01
03|-1|-1|-1|23|-1|-1|-1|-1|-1|-1|-1|-1|02|-1|-1|01|-1|01|-1|-1|-1|-1|-1|-1|-1|02|-1|-1|03
02|-1|-1|-1|-1|-1|-1|-1|-1|-1|-1|-1|-1|03|-1|-1|02|-1|-1|-1|02|-1|-1|-1|-1|-1|-1|-1|-1|02
03|-1|-1|01|-1|-1|-1|-1|-1|-1|-1|-1|-1|02|-1|-1|01|-1|03|-1|-1|-1|-1|-1|-1|-1|-1|-1|-1|01
01|-1|-1|-1|-1|-1|-1|-1|-1|-1|-1|-1|-1|-1|-1|-1|-1|-1|-1|-1|-1|-1|-1|-1|-1|-1|-1|-1|-1|02
03|-1|-1|-1|-1|-1|-1|-1|-1|-1|-1|-1|-1|-1|-1|-1|-1|-1|-1|-1|-1|-1|-1|-1|-1|-1|-1|-1|-1|03
01|03|01|03|02|01|03|01|03|02|03|01|02|03|27|-1|02|01|02|03|01|02|03|01|03|02|01|02|01|03

[CollisionLayer]
-1|-1|-1|-1|-1|-1|-1|-1|-1|-1|-1|-1|-1|-1|-1|-1|-1|-1|-1|-1|-1|-1|-1|-1|-1|-1|-1|-1|-1|-1
-1|00|00|00|00|00|00|-1|-1|-1|00|00|-1|-1|-1|-1|00|-1|-1|-1|-1|00|00|00|-1|-1|00|00|00|-1
-1|00|00|00|00|00|00|01|01|-1|00|00|-1|00|00|-1|00|-1|00|00|-1|00|00|00|-1|00|00|00|00|-1
-1|00|00|00|00|00|00|00|00|00|00|00|00|00|00|00|00|00|00|00|00|00|00|-1|-1|-1|-1|00|00|-1
-1|00|00|00|00|00|00|00|00|00|00|00|00|00|00|00|00|00|00|00|00|00|-1|-1|-1|-1|-1|00|00|-1
-1|00|00|00|00|00|00|00|00|00|00|00|00|00|00|00|00|00|00|00|00|00|-1|-1|-1|-1|-1|00|00|-1
-1|00|00|00|00|-1|00|-1|-1|-1|00|-1|00|00|00|00|00|-1|00|00|00|00|00|-1|-1|-1|00|00|00|-1
-1|00|00|00|-1|00|-1|00|00|-1|00|00|-1|00|00|00|00|00|-1|00|00|00|00|00|00|00|00|00|00|-1
-1|00|00|00|00|00|00|00|00|00|00|00|00|00|00|00|00|00|00|00|00|00|00|00|00|00|00|00|00|-1
-1|00|00|00|00|00|00|00|00|00|00|00|00|00|00|00|00|00|00|00|00|00|00|00|00|00|00|00|00|-1
-1|00|00|00|00|00|00|00|00|00|00|00|00|00|00|00|00|00|00|00|00|00|00|00|00|00|00|00|00|-1
-1|00|00|00|00|00|00|-1|-1|-1|-1|00|00|00|00|00|00|00|00|-1|-1|-1|-1|-1|00|00|00|00|00|-1
-1|00|00|-1|-1|-1|00|00|00|00|-1|00|00|00|-1|-1|00|00|00|-1|-1|00|-1|-1|00|00|00|00|00|-1
-1|00|00|02|-1|-1|00|00|00|00|-1|00|00|00|00|00|00|00|00|00|00|00|00|00|00|00|00|00|00|-1
-1|00|00|00|00|00|00|00|00|00|-1|00|00|00|00|00|00|00|00|-1|00|00|00|00|00|00|00|00|00|-1
-1|00|00|00|00|00|00|00|00|00|-1|00|00|00|00|00|00|00|00|-1|00|-1|00|00|00|00|00|00|00|-1
-1|00|00|00|00|00|00|00|00|00|-1|00|00|00|00|00|00|00|00|-1|00|00|00|00|00|00|00|00|00|-1
-1|00|00|00|00|00|00|00|00|00|-1|-1|-1|-1|00|00|-1|-1|-1|-1|00|00|-1|00|00|00|00|00|00|-1
-1|00|00|00|00|00|00|00|00|00|-1|-1|-1|-1|00|00|-1|00|00|00|00|00|00|00|00|00|00|00|00|-1
-1|00|00|00|00|00|00|00|00|00|-1|-1|-1|-1|00|00|-1|00|-1|00|-1|00|00|00|00|00|00|00|00|-1
-1|00|00|00|00|00|00|00|00|00|-1|00|00|-1|00|00|-1|00|00|00|00|00|00|00|00|00|00|00|00|-1
-1|00|00|00|00|00|00|00|00|00|00|00|00|00|00|00|00|00|00|00|00|00|00|00|00|00|00|00|00|-1
-1|00|00|00|00|00|00|00|00|00|00|00|00|00|00|00|00|00|00|00|00|00|00|00|00|00|00|00|00|-1
-1|00|00|00|00|00|00|00|00|-1|-1|-1|-1|-1|00|00|-1|00|00|00|-1|00|00|00|00|00|00|00|00|-1
-1|00|00|00|-1|-1|-1|00|00|-1|-1|-1|-1|-1|00|00|-1|00|-1|00|00|00|00|00|00|00|-1|00|00|-1
-1|00|00|00|-1|-1|-1|00|00|-1|-1|-1|-1|-1|00|00|-1|00|00|00|-1|00|00|00|00|00|00|00|00|-1
-1|00|00|-1|00|00|-1|00|00|-1|-1|00|-1|-1|00|00|-1|00|-1|00|00|00|00|00|00|00|00|00|00|-1
-1|00|00|00|00|00|00|00|00|00|00|00|00|00|00|00|00|00|00|00|00|00|00|00|00|00|00|00|00|-1
-1|00|00|00|00|00|00|00|00|00|00|00|00|00|00|00|00|00|00|00|00|00|00|00|00|00|00|00|00|-1
-1|-1|-1|-1|-1|-1|-1|-1|-1|-1|-1|-1|-1|-1|-1|-1|-1|-1|-1|-1|-1|-1|-1|-1|-1|-1|-1|-1|-1|-1
